بسم	bism
الرحمن	arraḥmān
الرحيم	arraḥīm
الحمد لله	al-ḥamdu lillāh
رب	rabb
العالمين	al-‘ālamīn
مالك	mālik
يوم	yaum
الدين	ad-dīn
إياك	iyyāk
نعبد	na’bud
و	wa
نستعين	nasta’īn
اهدنا	ihdinā
الصراط	aṣ-ṣirāṭ
المستقيم	al-mustaqīm
صراط	ṣirāṭ 
الذين	allażīn
أنعمت	an’amt
عليهم	‘alaihim
غير	gair
المغضوب	al-magḍụb
ولا الضالين	wa laḍ-ḍāllīn
ذلك	żālik
الكتاب	al-kitāb
لا ريب	lā raib
فيه	fīh
هدى	hudā
للمتقين	lil-muttaqīn
يؤمنون	yu`minụn
بالغيب	bil-gaib
يقيمون	yuqīmụn
الصلاة	aṣ-ṣalāh
مما	mimmā
رزقناهم	razaqnāhum
ينفقون	yunfiqụn
يؤمنون	yu`minụn
بما	bimā
أنزل	unzil
إليك	ilaik
وما	wa mā
من قبلك	ming qablik
وبالآخرة	wa bil-ākhirah
هم	hum
يوقنون	yụqinụn
أولئك	ulā`ik
على	‘alā
من ربهم	mir rabbihim
المفلحون	al-mufliḥụn
إن الذين	innallażīn
كفروا	kafarụ
سواء	sawā`
أأنذرتهم	a anżartahum
أم لم	am lam
تنذرهم	tunżir-hum
لا يؤمنون	lā yu`minụn
ختم الله	khatamallāh
قلوبهم	qulụbihim
سمعهم	sam’ihim
أبصارهم	abṣārihim
غشاوة	gisyāwah
ولهم	wa lahum
عذاب	‘ażāb
عظيم	‘aẓīm
ومن الناس	wa minan-nās
من يقول	may yaqụl
آمنا	āmannā
بالله	billāh
وباليوم	wa bil-yaum
الآخر	al-ākhir
وما هم	wa mā hum
بمؤمنين	bimu`minīn
يخادعون الله	yukhādi’ụnallāh
والذين	wallażīn
آمنوا	āmanụ
وما يخدعون	wa mā yakhda’ụn
إلا أنفسهم	illā anfusahum
وما يشعرون	wa mā yasy’urụn
في قلوبهم	fī qulụbihim
مرض	maraḍ
فزادهم الله	fa zādahumullāh
مرضا	maraḍā
أليم	alīm
كانوا	kānụ
يكذبون	yakżibụn
وإذا	wa iżā
قيل لهم	qīla lahum
لا تفسدوا	lā tufsidụ
في الأرض	fil arḍ
قالوا	qālụ
إنما	innamā
نحن	naḥn
مصلحون	muṣliḥụn
ألا إنهم	alā innahum
هم المفسدون	humul-mufsidụn
ولكن	wa lākin
لا يشعرون	lā yasy’urụn
كما	kamā
آمن الناس	āmanan-nās
أنؤمن	a nu`min
آمن السفهاء	āmanas-sufahā`
هم السفهاء	humus-sufahā`
لا يعلمون	lā ya’lamụn
السفهاء	as-sufahā`
لقوا	laqu
آمنا	āmannā
خلوا 	khalau
إلى	ilā
شياطينهم	syayāṭīnihim
إنا	innā
معكم	ma’akum
مستهزئون	mustahzi`ụn
الله	allāh
يستهزئ	yastahzi`
بهم	bihim
ويمدهم	wa yamudduhum
في طغيانهم	fī ṭugyānihim
يعمهون	ya’mahụn
الضلالة	aḍ-ḍalālah
بالهدى	bil-hudā
فما	fa mā
ربحت	rabiḥat
تجارتهم	tijāratuhum
مهتدين	muhtadīn
مثلهم	maṡaluhum
كمثل الذي	kamaṡalillāżi
نارا	nārā
فلما	fa lammā
أضاءت	aḍā`at
ما حوله	mā ḥaulah
ذهب الله 	żahaballāh
بنورهم	binụrihim
وتركهم	wa tarakahum
في ظلمات	fī ẓulumāt
لا يبصرون	lā yubṣirụn
صم	ṣumm
بكم	bukm
فهم	fa hum
لا يرجعون	lā yarji’ụn
أو	au
كصيب	kaṣayyib
من	min
السماء	as-samā`
ظلمات	ẓulumāt
ورعد	wa ra’d
وبرق	wa barq
يجعلون	yaj’alụn
أصابعهم	aṣābi’ahum
آذانهم	āżānihim
الصواعق	aṣ-ṣawā’iq
حذر	ḥażar
الموت	al-maụt
محيط	muḥīṭ
بالكافرين	bil-kāfirīn
يكاد	yakād
البرق	al-barqu
يخطف	yakhṭaf
أبصارهم	abṣārahum
كلما	kullamā
أضاء	aḍā`
لهم	lahum
مشوا	masyau
أظلم	aẓlam
قاموا	qāmụ
ولو شاء	walau syā`
لذهب	lażahab
بسمعهم	bisam’ihim
شيء قدير	syai`ing qadīr
يا أيها	yā ayyuhā
الناس	an-nās
ربكم	rabbakum
الذي	allażī
خلقكم	khalaqakum
قبلكم	qablikum
لعلكم	la’allakum
تتقون	tattaqụn
جعل	ja’al
 لكم	lakum
الأرض	al-arḍ
فراشا	firāsyā
بناء	binā`
ماء	mā`
فأخرج	fa akhraj
به	bih
الثمرات	aṡ-ṡamarāt
رزقا لكم	rizqal lakum
فلا تجعلوا	fa lā taj’alụ
لله	lillāh
أندادا	andādā
وأنتم	wa antum
تعلمون	ta’lamụn
وإن	wa in
كنتم	kuntum
في ريب	fī raib
نزلنا	nazzalnā
عبدنا	‘abdinā
فأتوا	fa`tụ
بسورة	bisụrah
مثله	miṡlih
وادعوا	wad’ụ
شهداءكم	syuhadā`akum
دون الله	dụnillāh
صادقين	ṣādiqīn
فإن	fa in
لم تفعلوا	lam taf’alụ
ولن تفعلوا	wa lan taf’alụ
فاتقوا	fattaqụ
النار	an-nār
التي	allatī
وقودها	waqụduhā
والحجارة	wal-ḥijārah
أعدت	u’iddat
للكافرين	lil-kāfirīn
وبشر	wa basysyir
وعملوا	wa ‘amilụ
الصالحات	aṣ-ṣāliḥāt
جنات	jannāt
تجري	tajrī
تحتها	taḥtihā
الأنهار	al-an-hār
رزقوا	ruziqụ
منها	min-hā
ثمرة	ṡamarah
رزقا	rizqā
هذا	hāżā
رزقنا	ruziqnā
قبل	qabl
وأتوا	wa utụ
متشابها	mutasyābihā
فيها	fīhā
أزواج	azwāj
مطهرة	muṭahharah
خالدون	khālidụn
إن الله	innallāh
لا يستحيي	lā yastaḥyī
أن يضرب	ay yaḍrib
مثلا	maṡalā
ما	mā
بعوضة	ba’ụḍah
فوقها	fauqahā
فأما	fa ammā
فيعلمون	fa ya’lamụn
أنه	annah
الحق	al-ḥaqq
وأما	wa ammā
فيقولون	fa yaqụlụna
ماذا	māżā
أراد	arād
أراد الله	arādallāhu
بهذا	bihāżā
مثلا	maṡalā
يضل	yuḍill
كثيرا	kaṡīrā
ويهدي	wa yahdī
يضل به	yuḍillu bihī
إلا الفاسقين	illāl-fāsiqīn
ينقضون	yangquḍụn
عهد الله	‘ahdallāh
من بعد	mim ba’d
ميثاقه	mīṡāqih
ويقطعون	wa yaqṭa’ụn
أمر الله	amarallāh
أن يوصل	ay yụṣal
ويفسدون	wa yufsidụn
في الأرض	fil-arḍ
الخاسرون	al-khāsirụn
هم الخاسرون	humul-khāsirụn
كيف	kaif
تكفرون	takfurụn
أمواتا	amwātā
فأحياكم	fa aḥyākum
ثم	ṡumm
يميتكم	yumītukum
يحييكم	yuḥyīkum
إليه	ilaih
ترجعون	turja’ụn
خلق	khalaq
خلق لكم	khalaqa lakum
جميعا	jamī’ā
ثم استوى	ṡummastawā
إلى السماء	ilas-samā`
فسواهن	fa sawwāhunn
سبع	sab’
سماوات	samāwāt
عليم	‘alīm
شيء عليم	syai`in ‘alīm
قال	qāl
ربك	rabbuk
للملائكة	lil-malā`ikah
إني	innī
جاعل	jā’il
خليفة	khalīfah
أتجعل	a taj’al
من يفسد	may yufsid
ويسفك	wa yasfik
الدماء	ad-dimā`
نسبح	nusabbiḥ
بحمدك	biḥamdik
ونقدس لك	wa nuqaddisu lak
أعلم	a’lam
وعلم	wa ‘allam
آدم	ādam
الأسماء	al-asmā`a
كلها	kullahā
عرضهم	‘araḍahum
على الملائكة	‘alal-malā`ikah
فقال	fa qāl
أنبئوني	a ambi`ụnī
بأسماء	bi`asmā`
هؤلاء	hā`ulā`
سبحانك	qālụ sub-ḥānak
لا علم لنا	lā ‘ilma lanā
إلا ما علمتنا	illā mā ‘allamtanā
أنبئهم	ambi`hum
بأسمائهم	bi`asmā`ihim
ألم	a lam
أقل	aqul
ما تبدون	mā tubdụn
تكتمون	taktumụn
للملائكة اسجدوا	lil-malā`ikatisjudụ
لآدم	li`ādam
فسجدوا	fa sajadụ
إلا	illā
إبليس	iblīs
أبى	abā
واستكبر	wastakbar
وقلنا	wa qulnā
يا آدم اسكن	yā ādamuskun
 أنت	ant
وزوجك	wa zaujuk
الجنة	al-jannah
 وكلا	wa kulā
رغدا	ragadā
حيث	ḥaiṡ
شئتما	syi`tumā
ولا تقربا	wa lā taqrabā
هذه	hāżih
الشجرة	asy-syajarah
فتكونا	fa takụnā
الظالمين	aẓ-ẓālimīn
فأزلهما	fa azallahumā
الشيطان	asy-syaiṭān
عنها	‘an-hā
فأخرجهما	fa akhrajahumā
كانا	kānā
وقلنا اهبطوا	wa qulnahbiṭụ
اهبطوا	ihbiṭụ
بعضكم	ba’ḍukum
لبعض	liba’ḍ
عدو	‘aduww
مستقر	mustaqarr
ومتاع	wa matā’
إلى حين	ilā ḥīn
فتلقى	fa talaqqā
من ربه	mir rabbih
كلمات	kalimāt
فتاب عليه	fa tāba ‘alaīh
التواب	at-tawwāb
فإما	fa immā
يأتينكم	ya`tiyannakum
مني	minni
فمن	fa man
تبع	tabi’
هداي	hudāy
خوف	khauf
يحزنون	yaḥzanụn
وكذبوا	wa każżabụ
بآياتنا	bi`āyātinā
أصحاب	aṣ-ḥāb
يا بني	yā banī
إسرائيل	isrā`īl
اذكروا	użkurụ
نعمتي	ni’matī
أنعمت	an’amt
وأوفوا	wa aufụ
بعهدي	bi’ahdī
أوف	ụf
بعهدكم	bi’ahdikum
وإياي	wa iyyāy
فارهبون	far-habụn
وآمنوا	wa āminụ
أنزلت	anzalt
مصدقا	muṣaddiqā
لما معكم	limā ma’akum
ولا تكونوا	wa lā takụnụ
أول	awwal
كافر به	kāfirim bih
ولا تشتروا	wa lā tasytarụ
بآياتي	bi`āyātī
ثمنا قليلا	ṡamanang qalīla
فاتقون	fattaqụn
ولا تلبسوا الحق	wa lā talbisul-ḥaqq
بالباطل	bil-bāṭil
وتكتموا الحق	wa taktumul-ḥaqq
وأقيموا الصلاة	wa aqīmuṣ-ṣalāh
وآتوا الزكاة	wa ātuz-zakāh
واركعوا	warka’ụ
مع الراكعين	ma’ar-rāki’īn
أتأمرون الناس	a ta`murụnan-nās
بالبر	bil-birr
وتنسون	wa tansaun
أنفسكم	anfusakum
تتلون الكتاب	tatlụnal-kitāb
أفلا تعقلون	a fa lā ta’qilụn
واستعينوا	wasta’īnụ
بالصبر	biṣ-ṣabr
والصلاة	waṣ-ṣalāh
وإنها	wa innahā
لكبيرة	lakabīrah
الخاشعين	al-khāsyi’īn
يظنون	yaẓunnụn
أنهم	annahum
ملاقو ربهم	mulāqụ rabbihim
وأنهم إليه راجعون	wa annahum ilaihi rāji’ụn
وأني فضلتكم	wa annī faḍḍaltukum
على العالمين	‘alal-‘ālamīn
واتقوا	wattaqụ
يوما لا تجزي	yaumal lā tajzi
نفس عن	nafsun ‘an
نفس شيئا	nafsin syai`a
ولا يقبل	wa lā yuqbal
منها شفاعة	min-hā syafā’ah
ولا يؤخذ	wa lā yu`khaż
منها عدل	min-hā ‘adl
ولا هم ينصرون	wa lā hum yunṣarụn
وإذ نجيناكم	wa iż najjainākum
من آل فرعون	min āli fir’aun
يسومونكم	yasụmụnakum
سوء العذاب	sū`al-‘ażāb
يذبحون	yużabbiḥụn
أبناءكم	abnā`akum
ويستحيون	wa yastaḥyụn
نساءكم	nisā`akum
فرعون	fir’aun
وفي ذلكم	wa fī żālikum
بلاء من ربكم	balā`um mir rabbikum
عظيم	‘aẓīm
وإذ فرقنا	wa iż faraqnā
بكم البحر	bikumul-baḥr
فأنجيناكم	fa anjainākum
وأغرقنا	wa agraqnā
آل فرعون	āla fir’aun
تنظرون	tanẓurụn
البحر	al-baḥr
بلاء	balā`
واعدنا	wā’adnā
موسى	mụsā
أربعين	arba’īn
ليلة	lailah
ثم اتخذتم العجل	ṡummattakhażtumul-‘ijl
ثم عفونا	ṡumma ‘afaunā
تشكرون	tasykurụn
تهتدون	tahtadụn
لقومه	liqaumih
يا قوم	yā qaum
إنكم	innakum
ظلمتم	ẓalamtum
باتخاذكم	bittikhāżikum
العجل	al-‘ijl
فتوبوا	fa tụbụ
إلى بارئكم	ilā bāri`ikum
فاقتلوا أنفسكم	faqtulū anfusakum
ذلكم	żālikum
خير لكم	khairul lakum
عند بارئكم	‘inda bāri`ikum
خير	khair
فتاب عليكم	fa tāba ‘alaikum
إنه هو التواب الرحيم	innahụ huwat-tawwābur-raḥīm
قلتم	qultum
لن نؤمن لك	lan nu`mina lak
حتى	ḥattā
نرى الله	narallāh
جهرة	jahrah
فأخذتكم	fa akhażatkum
الصاعقة	aṣ-ṣā’iqah
بعثناكم	ba’aṡnākum
موتكم	mautikum
وظللنا	wa ẓallalnā
الغمام	al-gamām
وأنزلنا	wa anzalnā
المن	al-mann
والسلوى	was-salwā
كلوا	kulụ
طيبات	ṭayyibāt
ما رزقناكم	mā razaqnākum
ادخلوا	udkhulụ
هذه القرية	hāżihil-qaryah
القرية	al-qaryah
فكلوا	fa kulụ
حيث شئتم	ḥaiṡu syi`tum
رغدا	ragadā
وادخلوا	wadkhulụ
الباب	al-bāb
سجدا	sujjadā
وقولوا	wa qụlụ
حطة	ḥiṭṭah
نغفر لكم	nagfir lakum
خطاياكم	khaṭāyākum
وسنزيد	wa sanazīd
المحسنين	al-muḥsinīn
فبدل الذين	fa baddalallażīn
ظلموا	ẓalamụ
قولا	qaulā
غير الذي	gairallażī
فأنزلنا	fa anzalnā
على الذين	‘alallażīn
رجزا	rijzā
من السماء	minas-samā`
بما كانوا	bimā kānụ
يفسقون	yafsuqụn
وإذ استسقى	wa iżistasqā
فقلنا اضرب	fa qulnaḍrib
بعصاك الحجر	bi’aṣākal-ḥajar
فانفجرت	fanfajarat
منه اثنتا	min-huṡnatā
عشرة	‘asyrah
عينا	‘ainā
قد علم	qad ‘alim
كل أناس	kullu unās
مشربهم	masyrabahum
كلوا واشربوا	kulụ wasyrabụ
من رزق الله	mir rizqillāh
ولا تعثوا	wa lā ta’ṡau
في الأرض مفسدين	fil-arḍi mufsidīn
لن نصبر	lan naṣbir
على طعام	‘alā ṭa’ām
واحد	wāḥid
فادع لنا	fad’u lanā
ربك يخرج	rabbaka yukhrij
لنا	lanā
مما تنبت الأرض	mimmā tumbitul-arḍ
من بقلها	mim baqlihā
وقثائها	wa qiṡṡā`ihā
وفومها	wa fụmihā
وعدسها	wa ‘adasihā
وبصلها	wa baṣalihā
أتستبدلون الذي	a tastabdilụnallażī
هو أدنى	huwa adnā
بالذي	billāżī
هو خير	huwa khaīr
اهبطوا مصرا	ihbiṭụ miṣrā
فإن لكم	fa inna lakum
ما سألتم	mā sa`altum
وضربت	wa ḍuribat
عليهم الذلة	‘alaihimuż-żillāh
الذلة	aż-żillāh
والمسكنة	wal-maskanah
وباءوا	wa bā`ụ
بغضب	bigaḍab
من الله	minallāh
ذلك بأنهم	żālika bi`annahum
يكفرون	yakfurụn
بآيات الله	bi`āyātillāh
ويقتلون	wa yaqtulụn
النبيين	an-nabiyyīn
بغير الحق	bigairil-ḥaqq
ذلك بما	żālika bimā
عصوا وكانوا	‘aṣaw wa kānụ
يعتدون	ya’tadụn
إن الذين آمنوا	innallażīna āmanụ
والذين هادوا	wallażīna hādụ
والنصارى	wan-naṣārā
والصابئين	waṣ-ṣābi`īn
من آمن بالله	man āmana billāh
واليوم الآخر	wal-yaumil-ākhir
وعمل صالحا	wa ‘amila ṣāliḥā
فلهم أجرهم	fa lahum ajruhum
عند ربهم	‘inda rabbihim
ولا خوف عليهم	wa lā khaufun ‘alaihim
ولا هم يحزنون	wa lā hum yaḥzanụn
وإذ أخذنا	wa iż akhażnā
ميثاقكم	mīṡāqakum
ورفعنا	wa rafa’na
فوقكم الطور	fauqakumuṭ-ṭụr
الطور	aṭ-ṭụr
فوقكم	fauqakum
خذوا	khużụ
ما آتيناكم	mā ātainākum
بقوة	biquwwah
واذكروا	ważkurụ
ما فيه	mā fīh
لعلكم تتقون	la’allakum tattaqụn
ثم توليتم	ṡumma tawallaitum
من بعد ذلك	mim ba’di żālik
فلولا	falau lā
فضل الله عليكم	faḍlullāhi ‘alaikum
ورحمته لكنتم	wa raḥmatuhụ lakuntum
من الخاسرين	minal-khāsirīn
علمتم الذين اعتدوا	wa laqad ‘alimtumullażīna’tadau
في السبت	fis-sabt
فقلنا لهم	fa qulnā lahum
كونوا قردة خاسئين	kụnụ qiradatan khāsi`īn
خاسئين	khāsi`īn
قردة	qiradah
فجعلناها	fa ja’alnāhā
نكالا لما	nakālal limā
بين يديها	baina yadaihā
وما خلفها	wa mā khalfahā
وموعظة للمتقين	wa mau’iẓatal lil-muttaqīn
وإذ قال	wa iż qāl
موسى لقومه	mụsā liqaumihī
إن الله يأمركم	innallāha ya`murukum
أن تذبحوا بقرة	an tażbaḥụ baqarah
قالوا أتتخذنا	qālū a tattakhiżuna
قال أعوذ بالله	qāla a’ụżu billāh
هزوا	huzuwā
أن أكون من الجاهلين	an akụna minal-jāhilīn
من الجاهلين	minal-jāhilīn
قالوا ادع لنا	qālud’u lanā
قال إنه يقول	qāla innahụ yaqụl
ربك يبين لنا	rabbaka yubayyil lanā
إنها بقرة	innahā baqarah
لا فارض	lā fāriḍ
ولا بكر	wa lā bikr
عوان بين ذلك	‘awānum baina żālik
فافعلوا ما تؤمرون	faf’alụ mā tu`marụn
قالوا ادع لنا ربك يبين لنا	qālud’u lanā rabbaka yubayyil lanā
قال إنه يقول إنها	qāla innahụ yaqụlu innahā
ما لونها	mā launuhā
بقرة صفراء	baqaratun ṣafrā`
فاقع لونها	fāqi’ul launuhā
تسر الناظرين	tasurrun-nāẓirīn
تسر	tasurr
الناظرين	an-nāẓirīn
لنا ما هي إن البقر	lanā mā hiya innal-baqar
وإنا إن شاء الله	wa innā in syā`allāh
تشابه علينا	tasyābaha ‘alainā
لمهتدون	lamuhtadụn
بقرة لا ذلول	baqaratul lā żalụlu
مسلمة لا شية	musallamatul lā syiyah
لا ذلول تثير الأرض	lā żalụlun tuṡīrul-arḍ
ولا تسقي الحرث	wa lā tasqil-ḥarṡ
لا شية فيها	lā syiyata fīhā
قالوا الآن	qālul-ān
جئت بالحق	ji`ta bil-ḥaqq
فذبحوها	fa żabaḥụhā
وما كادوا يفعلون	wa mā kādụ yaf’alụn
وإذ قتلتم	wa iż qataltum
والله مخرج ما	wallāhu mukhrijum mā
نفسا فادارأتم فيها	nafsan faddāra’tum fīhā
كنتم تكتمون	kuntum taktumụn
فقلنا اضربوه	fa qulnaḍribụh
ببعضها	biba’ḍihā
كذلك يحيي الله	każālika yuḥyillāh
الموتى ويريكم	al-mautā wa yurīkum
آياته لعلكم	āyātihī la’allakum
تعقلون	ta’qilụn
ثم قست	ṡumma qasat
قلوبكم	qulụbukum
من بعد ذلك	mim ba’di żālik
كالحجارة	kal-ḥijārah
أو أشد قسوة	au asyaddu qaswah
وإن من الحجارة	wa inna minal-ḥijārah
الحجارة لما	al-ḥijārati lamā
يتفجر منه	yatafajjaru min-h
منه الأنهار	min-hul-an-hār
لما يشقق	lamā yasysyaqqaq
يشقق فيخرج	yasysyaqqaqu fa yakhruj
فيخرج منه الماء	fa yakhruju min-hul-mā`
يهبط من خشية الله	yahbiṭu min khasy-yatillāh
يهبط	yahbiṭ
من خشية	min khasy-yah
وما الله بغافل	wa mallāhu bigāfil
 بغافل عما تعملون	bigāfilin ‘ammā ta’malụn
أفتطمعون	a fa taṭma’ụn
أن يؤمنوا لكم	ay yu`minụ lakum
كان فريق منهم	kāna farīqum min-hum
يسمعون كلام الله	yasma’ụna kalāmallāh
يحرفونه من بعد ما	yuḥarrifụnahụ mim ba’di mā
عقلوه وهم	‘aqalụhu wa hum
يحرفونه	yuḥarrifụnah
عقلوه	‘aqalụh
فريق	farīq
يسمعون	yasma’ụn
كلام	kalām
وإذا لقوا الذين	wa iżā laqullażīn
آمنوا قالوا آمنا	āmanụ qālū āmannā
وإذا خلا بعضهم	wa iżā khalā ba’ḍuhum
إلى بعض قالوا	ilā ba’ḍing qālụ
أتحدثونهم	a tuḥaddiṡụnahum
بما فتح الله	bimā fataḥallāh
ليحاجوكم	liyuḥājjụkum
به عند ربكم	bihī ‘inda rabbikum
أولا يعلمون	a wa lā ya’lamụn
أن الله يعلم ما	annallāha ya’lamu mā
يسرون وما	yusirrụna wa mā yu’linụn
يعلنون	yu’linụn
يسرون	yusirrụn
أميون لا	ummiyyụna lā
يعلمون الكتاب	ya’lamụnal-kitāb
إلا أماني	illā amānī
إلا يظنون	illā yaẓunnụn
أماني إلا	amāniyya illā 
الكتاب إلا	al-kitāba illā
فويل للذين	fa wailul lillāżīn
يكتبون الكتاب بأيديهم	yaktubụnal-kitāba bi`aidīhim
ثم يقولون هذا	yaqụlụna hāżā
هذا من عند الله	hāżā min ‘indillāh
ليشتروا به	liyasytarụ bih
ثمنا قليلا	ṡamanang qalīlā
فويل لهم	fa wailul lahum
مما كتبت	mimmā katabat
أيديهم	aidīhim
وويل لهم	wa wailul lahum
مما يكسبون	mimmā yaksibụn
وقالوا لن	wa qālụ lan
لن تمسنا النار	lan tamassanan-nār
النار إلا	an-nāru illā
أياما معدودة	ayyāmam ma’dụdah
أياما	ayyāmā
قل أتخذتم	qul attakhażtum
عهدا	‘ahdā
عهدا فلن يخلف الله	‘ahdan fa lay yukhlifallāh
عهده أم	‘ahdahū am
فلن يخلف	fa lay yukhlif
عهده	‘ahdah
تقولون على	taqụlụna ‘alā
على الله	‘alallāh
بلى من كسب	balā mang kasab
كسب سيئة	kasaba sayyi`ah
سيئة وأحاطت	sayyi`ataw wa `aḥāṭat
به خطيئته	bihī khaṭī`atuh
خطيئته فأولئك	khaṭī`atuhụ fa ulā`ik
فأولئك أصحاب	fa ulā`ika aṣ-ḥāb
أصحاب النار	aṣ-ḥābun-nār
آمنوا وعملوا	āmanụ wa ‘amilụ
وعملوا الصالحات	wa ‘amiluṣ-ṣāliḥāt
الصالحات أولئك	aṣ-ṣāliḥāti ulā`ik
أولئك أصحاب	ulā`ika aṣ-ḥāb
أصحاب الجنة	aṣ-ḥābul-jannah
هم فيها خالدون	hum fīhā khālidụn
أخذنا ميثاق	akhażnā mīṡāq
ميثاق بني	mīṡāqa banī
بني إسرائيل	banī isrā`īl
إسرائيل لا	isrā`īla lā
لا تعبدون	lā ta’budụn
تعبدون إلا	ta’budụna illā
إلا الله	illāllāh
وبالوالدين إحسانا	wa bil-wālidaini iḥsānā
إحسانا وذي	iḥsānaw wa żī
وذي القربى	wa żil-qurbā
القربى واليتامى	al-qurbā wal-yatāmā
واليتامى والمساكين	wal-yatāmā wal-masākīn
والمساكين وقولوا	wal-masākīni wa qụlụ
وقولوا للناس	wa qụlụ lin-nās
للناس حسنا	lin-nāsi ḥusnā
حسنا وأقيموا	ḥusnaw wa aqīmụ
وأقيموا الصلاة	wa aqīmuṣ-ṣalāh
الصلاة وآتوا	aṣ-ṣalāta wa ātụ
وآتوا الزكاة	wa ātuz-zakāh
ثم توليتم	ṡumma tawallaitum
إلا قليلا	illā qalīlā
قليلا منكم	qalīlam mingkum
معرضون	mu’riḍụn
لا تسفكون	lā tasfikụn
لا تسفكون دماءكم	lā tasfikụna dimā`akum
ولا تخرجون	wa lā tukhrijụn
تخرجون أنفسكم	tukhrijụna anfusakum
من دياركم	min diyārikum
أقررتم	aqrartum
تشهدون	tasy-hadụn
هؤلاء	hā`ulā`
هؤلاء تقتلون	hā`ulā`i taqtulụn
تقتلون أنفسكم	taqtulụna anfusakum
وتخرجون فريقا	wa tukhrijụna farīqā
فريقا منكم	farīqam mingkum
من ديارهم	min diyārihim
تظاهرون	taẓāharụn
تظاهرون عليهم	taẓāharụna ‘alaihim
بالإثم	bil-iṡm
بالإثم والعدوان	bil-iṡmi wal-‘udwān
العدوان	al-‘udwān
وتخرجون	wa tukhrijụn
وإن يأتوكم	wa iy ya`tụkum
أسارى	usārā
أسارى تفادوهم	usārā tufādụhum
وهو محرم	wa huwa muḥarram
محرم عليكم	muḥarramun ‘alaikum
إخراجهم	ikhrājuhum
أفتؤمنون	a fa tu`minụn
أفتؤمنون ببعض	a fa tu`minụna biba’ḍ
ببعض الكتاب	biba’ḍil-kitāb
الكتاب وتكفرون	al-kitābi wa takfurụn
وتكفرون ببعض	wa takfurụna biba’ḍ
فما جزاء 	fa mā jazā`
جزاء من	jazā`u man
من يفعل	may yaf’al
يفعل ذلك	yaf’alu żālik
ذلك منكم	żālika mingkum
إلا خزي	illā khizy
خزي في	khizyun fī
في الحياة	fil-ḥayāh
الحياة الدنيا	al-ḥayātid-dun-yā
الدنيا	ad-dun-yā
ويوم	wa yaum
يوم القيامة	yaumal-qiyāmah
القيامة يردون	al-qiyāmati yuraddụn
يردون إلى	yuraddụna ilā
إلى أشد	ilā asyad
أشد العذاب	asyaddil-‘ażāb
العذاب	al-‘ażāb
بغافل عما	bigāfilin ‘amma
الذين اشتروا	allażīnasytaraw
اشتروا الحياة	asytarawul-ḥayāh
بالآخرة فلا	bil-ākhirati fa lā
فلا يخفف	fa lā yukhaffaf
يخفف عنهم	yukhaffafu ‘an-hum
عنهم العذاب	‘an-humul-‘ażāb
العذاب ولا	al-‘ażābu wa lā
ينصرون	yunṣarụn
آتينا	ātainā
آتينا موسى	ātainā mụsā
موسى الكتاب	mụsal-kitāb
الكتاب وقفينا	al-kitāba wa qaffainā
وقفينا من	wa qaffainā min
من بعده	mim ba’dih
بعده بالرسل	ba’dihī bir-rusul
بالرسل وآتينا	bir-rusuli wa ātainā
وآتينا عيسى	wa ātainā ‘īsā
عيسى ابن	‘īsabn
ابن مريم	ibna maryam
مريم البينات	maryamal-bayyināt
البينات وأيدناه	al-bayyināti wa ayyadnāh
وأيدناه بروح	wa ayyadnāhu birụḥ
بروح القدس	birụḥil-qudus
أفكلما	a fa kullamā
أفكلما جاءكم	a fa kullamā jā`akum
رسول بما	rasụlum bima
بما لا تهوى	bimā lā tahwā
تهوى أنفسكم	tahwā anfusukum
أنفسكم استكبرتم	anfusukumustakbartum
ففريقا	fa farīqā
ففريقا كذبتم	fa farīqang każżabtum
وفريقا	wa farīqā
وفريقا تقتلون	wa farīqan taqtulụn
وقالوا قلوبنا	wa qālụ qulụbunā
قلوبنا غلف	qulụbunā gulf
بل	bal
بل لعنهم	bal la’anahum
لعنهم الله	la’anahumullāh
الله بكفرهم	allāhu bikufrihim
بكفرهم فقليلا	bikufrihim fa qalīlā
فقليلا ما يؤمنون	fa qalīlam mā yu`minụn
ولما جاءهم	wa lammā jā`ahum
جاءهم كتاب	jā`ahum kitāb
كتاب من	kitābum min
مصدق لما	muṣaddiqul limā
لما معهم	limā ma’ahum
معهم وكانوا	ma’ahum wa kānụ
وكانوا من	wa kānụ min
من قبل	ming qabl
قبل يستفتحون	qablu yastaftiḥụn
يستفتحون على	yastaftiḥụna ‘alā
الذين كفروا	allażīna kafarụ
فلما جاءهم	fa lammā jā`ahum
جاءهم ما	jā`ahum mā
ما عرفوا	mā ‘arafụ
عرفوا كفروا	‘arafụ kafarụ
كفروا به	kafarụ bih
به فلعنة	bihī fa la’nah
فلعنة الله	fa la’natullāh
الله على	allāhi ‘alā
على الكافرين	‘alal-kāfirīn
بئسما	bi`samā
بئسما اشتروا	bi`samasytarau
اشتروا به	asytarau bih
به أنفسهم	bihī anfusahum
أنفسهم أن	anfusahum an
أن يكفروا	ay yakfurụ
يكفروا بما	yakfurụ bimā
بما أنزل	bimā anzal
أنزل الله	anzalallāh
الله بغيا	allāhu bagyā
بغيا أن	bagyan an
أن ينزل	ay yunazzil
ينزل الله	yunazzilallāh
الله من	allāhu min
من فضله	min faḍlih
فضله على	faḍlihī ‘alā
على من	alā man
من يشاء	may yasyā`
يشاء من	yasyā`u min
من عباده	min ‘ibādih
فباءوا	fa bā`ụ
فباءوا بغضب	fa bā`ụ bigaḍab
بغضب على	bigaḍabin ‘alā
على غضب	‘alā gaḍab
وللكافرين	wa lil-kāfirīn
للكافرين عذاب	wa lil-kāfirīna ‘ażāb
عذاب مهين	‘ażābum muhīn
وإذا قيل	wa iżā qīl
لهم آمنوا	lahum āminụ
آمنوا بما	āminụ bimā
بما أنزل	bimā anzal
الله قالوا 	allāhu qālụ
قالوا نؤمن	qālụ nu`min
نؤمن بما	nu`minu bimā
بما أنزل	bimā unzil
أنزل علينا	unzila ‘alainā
علينا ويكفرون	‘alainā wa yakfurụn
ويكفرون بما	wa yakfurụna bimā
بما وراءه	bimā warā`ah
وراءه وهو	warā`ahụ wa hụ
هو الحق	huwal-ḥaqq
الحق مصدقا	al-ḥaqqu muṣaddiqa
مصدقا لما	muṣaddiqal limā
قل فلم	qul fa lim
فلم تقتلون	fa lima taqtulụn
تقتلون أنبياء	taqtulụna ambiyā`
أنبياء الله	ambiyā`allāh
الله من	allāhi min
قبل إن	qablu in
إن كنتم	ing kuntum
مؤمنين	mu`minīn
جاءكم	jā`akum
موسى بالبينات	mụsā bil-bayyināt
بالبينات ثم	bil-bayyināti ṡumm
ثم اتخذتم	ṡummattakhażtum
اتخذتم العجل	attakhażtumul-‘ijl
العجل من	al-‘ijla min
ظالمون	ẓālimụn
أخذنا	akhażnā
ميثاقكم ورفعنا	mīṡāqakum wa rafa’nā
ورفعنا فوقكم	wa rafa’nā fauqakum
فوقكم الطور	fauqakumuṭ-ṭụr
خذوا ما	khużụ mā
ما آتيناكم	mā ātainākum
آتيناكم بقوة	ātainākum biquwwah
بقوة واسمعوا	biquwwatiw wasma’ụ
قالوا سمعنا	qālụ sami’nā
سمعنا وعصينا	sami’nā wa ‘aṣainā
وعصينا وأشربوا	wa ‘aṣainā wa usyribụ
وأشربوا في	wa usyribụ fī
في قلوبهم	fī qulụbihim
قلوبهم العجل	qulụbihimul-‘ijl
العجل بكفرهم	al-‘ijla bikufrihim
قل بئسما	qul bi`samā
بئسما يأمركم	bi`samā ya`murukum
يأمركم به	ya`murukum bih
به إيمانكم	bihī īmānukum
إيمانكم إن	īmānukum in
قل إن	qul in
إن كانت	ing kānat
كانت لكم	kānat lakum
لكم الدار	lakumud-dār
الدار الآخرة	ad-dārul-ākhirah
الآخرة عند	al-ākhiratu ‘ind
الله خالصة	allāhi khāliṣah
خالصة من	khāliṣatam min
من دون	min dụn
دون الناس	dụnin-nās
الناس فتمنوا	an-nāsi fa tamannawụ
فتمنوا الموت	fa tamannawul-maut
الموت إن	al-mauta in
ولن يتمنوه	wa lay yatamannauh
يتمنوه أبدا	yatamannauhu abadā
أبدا بما	abadam bimā
بما قدمت	bimā qaddamat
والله عليم	wallāhu ‘alīm
عليم بالظالمين	‘alīmum biẓ-ẓālimīn
ولتجدنهم	wa latajidannahum
أحرص الناس	aḥraṣan-nās
الناس على	an-nāsi ‘alā
على حياة	‘alā ḥayāh
الذين أشركوا	allażīna asyrakụ
أشركوا يود	asyrakụ yawad
يود أحدهم	yawaddu aḥaduhum
لو يعمر	lau yu’ammar
يعمر ألف	yu’ammaru alf
ألف سنة	alfa sanah
هو بمزحزحه	huwa bimuzaḥziḥih
بمزحزحه من	bimuzaḥziḥihī min
من العذاب	minal-‘ażāb
العذاب أن	al-‘ażābi an
أن يعمر	ay yu’ammar
والله بصير	wallāhu baṣīr
بصير بما	baṣīrum bimā
بما يعملون	bimā ya’malụn
قل من	qul man
من كان	mang kān
كان عدوا لجبريل	kāna ‘aduwwal lijibrīl
فإنه نزله	fa innahụ nazzalah
نزله على	nazzalahụ ‘alā
على قلبك	‘alā qalbik
قلبك بإذن	qalbika bi`iżn
بإذن الله	bi`iżnillāh
الله مصدقا	allāhi muṣaddiqā
مصدقا لما	muṣaddiqal limā
لما بين	limā bain
بين يديه	baina yadaih
يديه وهدى	yadaihi wa hudā
وهدى وبشرى	wa hudaw wa busyrā
وبشرى للمؤمنين	wa busyrā lil-mu`minīn
كان عدوا لله	kāna ‘aduwwal lillāh
وملائكته ورسله	wa malā`ikatihī wa rusulih
ورسله وجبريل	wa rusulihī wa jibrīl
وجبريل وميكال	wa jibrīla wa mīkāl
وميكال فإن	wa mīkāla fa in
فإن الله	fa innallāh
عدو للكافرين	‘aduwwul lil-kāfirīn
أنزلنا إليك	anzalnā ilaik
إليك آيات	ilaika āyāt
آيات بينات	āyātim bayyināt
يكفر بها	yakfuru bihā
إلا الفاسقون	illāl-fāsiqụn
أوكلما	a wa kullamā
أوكلما عاهدوا	a wa kullamā ‘āhadụ
عاهدوا عهدا	‘āhadụ ‘ahdā
عهدا نبذه	‘ahdan nabażah
نبذه فريق	nabażahụ farīq
فريق منهم	farīqum min-hum
بل أكثرهم	bal akṡaruhum
رسول من	rasụlum min
نبذ فريق	nabaża farīq
فريق من	farīqum min
أوتوا الكتاب	ụtul-kitāb
الكتاب كتاب	al-kitāba kitāb
كتاب الله	kitāballāh
الله وراء	allāhi warā`
وراء ظهورهم	warā`a ẓuhụrihim
كأنهم	ka`annahum
واتبعوا	wattaba’ụ
ما تتلو الشياطين	mā tatlusy-syayāṭīn
الشياطين على	asy-syayāṭīnu ‘alā
على ملك	‘alā mulk
ملك سليمان	mulki sulaimān
وما كفر	wa mā kafar
كفر سليمان	kafara sulaimān
سليمان ولكن	sulaimānu wa lākin
ولكن الشياطين	wa lākinnasy-syayāṭīn
الشياطين كفروا	asy-syayāṭīna kafarụ
كفروا يعلمون	kafarụ yu’allimụn
يعلمون الناس	yu’allimụnan-nās
الناس السحر	an-nāsas-siḥr
السحر وما	as-siḥra wa mā
وما أنزل	wa mā unzil
أنزل على	unzila ‘alā
على الملكين	‘alal-malakain
الملكين ببابل	al-malakaini bibābil
ببابل هاروت	bibābila hārụt
هاروت وماروت	hārụta wa mārụt
وما يعلمان	wa mā yu’allimān
يعلمان من	yu’allimāni min
من أحد	min aḥad
أحد حتى	aḥadin ḥattā
حتى يقولا	ḥattā yaqụlā
يقولا إنما	yaqụlā innamā
إنما نحن	innamā naḥn
نحن فتنة	naḥnu fitnah
فتنة فلا	fitnatun fa lā
فلا تكفر	fa lā takfur
فيتعلمون	fa yata’allamụn
فيتعلمون منهما	fa yata’allamụna min-humā
منهما ما	min-humā mā
ما يفرقون	mā yufarriqụn
يفرقون به	yufarriqụna bih
به بين	bihī bain
بين المرء	bainal-mar’
المرء وزوجه	al-mar’i wa zaujih
بضارين به	biḍārrīna bih
به من	bihī min
أحد إلا	aḥadin illā
إلا بإذن الله	illā bi`iżnillāh
ويتعلمون	wa yata’allamụn
ويتعلمون ما	wa yata’allamụna mā
ما يضرهم	mā yaḍurruhum
ولا ينفعهم	wa lā yanfa’uhum
علموا	‘alimụ
علموا لمن	‘alimụ laman
لمن اشتراه	lamanisytarāh
اشتراه ما	asytarāhu mā
ما له في	mā lahụ fī
في الآخرة	fil-ākhirah
الآخرة من	al-ākhirati min
من خلاق	min khalāq
ولبئس	wa labi`s
ولبئس ما	wa labi`sa ma
ما شروا	mā syarau
شروا به	syarau bih
به أنفسهم	bihī anfusahum
ولو أنهم	walau annahum
آمنوا واتقوا	āmanụ wattaqau
واتقوا لمثوبة	wattaqau lamaṡụbah
لمثوبة من	lamaṡụbatum min
خير لو	khaīr lau
يا أيها	yā ayyuhā
أيها الذين	ayyuhallażīn
الذين آمنوا	ażīna āmanụ
آمنوا لا	āmanụ lā
لا تقولوا راعنا	lā taqụlụ rā’inā
راعنا وقولوا	rā’inā wa qụlu
وقولوا انظرنا	wa qụlunẓurnā
انظرنا واسمعوا	unẓurnā wasma’ụ
واسمعوا وللكافرين	wasma’ụ wa lil-kāfirīn
وللكافرين عذاب	wa lil-kāfirīna ‘ażāb
عذاب أليم	‘ażābun alīm
ما يود	mā yawad
يود الذين	yawaddullażīn
كفروا من	kafarụ min
من أهل	min ahl
أهل الكتاب	ahlil-kitāb
الكتاب ولا	al-kitābi wa lā
المشركين أن	al-musyrikīna an
ينزل عليكم	yunazzala ‘alaikum
من خير	min khair
خير من	khairim min
من ربكم	mir rabbikum
والله يختص	wallāhu yakhtaṣ
يختص برحمته	yakhtaṣṣu biraḥmatih
برحمته من يشاء	biraḥmatihī may yasyā`
ذو الفضل	żul-faḍl
الفضل العظيم	al-faḍlil-‘aẓīm
ما ننسخ	mā nansakh
من آية	min āyah
آية أو	āyatin au
أو ننسها	au nunsihā
ننسها نأت	nunsihā na`t
نأت بخير	na`ti bikhair
بخير منها	bikhairim min-hā
منها أو	min-hā au
أو مثلها	au miṡlihā
ألم تعلم	a lam ta’lam 
أن الله	annallāh
على كل	‘alā kull
كل شيء	kulli syai`
الله له	allāha lah
له ملك	lahụ mulk
ملك السماوات	mulk
السماوات والأرض	as-samāwāti wal-arḍ
من ولي	miw walī
ولي ولا	waliyyiw wa la
ولا نصير	wa lā naṣīr
أم تريدون	am turīdụn
تريدون أن	turīdụna an
أن تسألوا	an tas`alụ
تسألوا رسولكم	tas`alụ rasụlakum
رسولكم كما	rasụlakum kamā
كما سئل	kamā su`il
سئل موسى	su`ila mụsā
موسى من	mụsā min
ومن يتبدل	wa may yatabaddal
يتبدل الكفر	yatabaddalil-kufr
الكفر بالإيمان	al-kufra bil-īmān
بالإيمان فقد	bil-īmāni fa qad
فقد ضل	fa qad ḍal
ضل سواء	ḍalla sawā`
سواء السبيل	sawā`as-sabīl
ود كثير	wadda kaṡīr
كثير من	kaṡīrum min
الكتاب لو	al-kitābi lau
لو يردونكم	lau yaruddụnakum
يردونكم من	yaruddụnakum min
إيمانكم كفارا	īmānikum kuffārā
حسدا من	ḥasadam min
من عند	min ‘ind
عند أنفسهم	‘indi anfusihim
بعد ما	ba’di mā
ما تبين	mā tabayyan
تبين لهم	tabayyana lahum
لهم الحق	lahumul-ḥaqq
فاعفوا	fa’fụ
فاعفوا واصفحوا	fa’fụ waṣfaḥụ
واصفحوا حتى	waṣfaḥụ ḥattā
حتى يأتي	ḥattā ya`tiy
يأتي الله	ya`tiyallāh
الله بأمره	allāhu bi`amrih
وما تقدموا	wa mā tuqaddimụ
تقدموا لأنفسكم	tuqaddimụ li`anfusikum
لأنفسكم من	li`anfusikum min 
خير تجدوه	khairin tajidụh
تجدوه عند	tajidụhu ‘ind
تعملون بصير	ta’malụna baṣīr
لن يدخل	lay yadkhul
يدخل الجنة	yadkhulal-jannah
الجنة إلا	yadkhulal-jannata illā
إلا من	llā man
كان هودا	kāna hụdā
هودا أو	hụdan au
أو نصارى	au naṣārā
تلك أمانيهم	tilka amāniyyuhum
قل هاتوا	qul hātụ
هاتوا برهانكم	hātụ bur-hānakum
برهانكم إن	bur-hānakum in
من أسلم	man aslam
أسلم وجهه	aslama waj-hah
وجهه لله	waj-hahụ lillāh
لله وهو	illāhi wa hụ
وهو محسن	wa huwa muḥsin
محسن فله	muḥsinun fa lah
فله أجره	fa lahū ajruh
أجره عند	ajruhụ ‘ind
عند ربه	inda rabbih
ربه ولا	rabbihī wa lā
ولا خوف	wa lā khauf
خوف عليهم	khaufun ‘alaihim
وقالت	wa qālat
وقالت اليهود	wa qālatil-yahụd
اليهود ليست	al-yahụdu laisat
ليست النصارى	laisatin-naṣārā
النصارى على	an-naṣārā ‘alā
شيء وقالت	syai`iw wa qālat
وقالت النصارى	wa qālatin-naṣārā
النصارى ليست	an-naṣārā laisat
ليست اليهود	laisatil-yahụd
اليهود على	al-yahụdu ‘alā
شيء وهم	syai`iw wa hum
يتلون الكتاب	yatlụnal-kitā
كذلك قال	każālika qālā
قال الذين	qālallażīn
الذين لا	allażīna lā
يعلمون مثل	ya’lamụna miṡl
مثل قولهم	miṡla qaulihim
فالله يحكم	fallāhu yaḥkum
بينهم	bainahum
القيامة فيما 	al-qiyāmati fīmā
فيما كانوا	fīmā kānụ
كانوا فيه	kānụ fīh
فيه يختلفون	fīhi yakhtalifụn
أظلم ممن	aẓlamu mim man
ممن منع	mim mam mana’
منع مساجد	mana’a masājid
مساجد الله	masājidallāh
الله أن	allāhi an
أن يذكر	ay yużkar
يذكر فيها	yużkara fīhā
فيها اسمه	fīhasmuhu
اسمه وسعى	ismuhụ wa sa’ā
وسعى في	wa sa’ā fi
في خرابها	fī kharābihā
أولئك ما	ulā`ika mā
أن يدخلوها	ay yadkhulụhā
يدخلوها إلا	yadkhulụhā illā
إلا خائفين	illā khā`ifīn
الدنيا خزي	ad-dun-yā khizy
خزي ولهم	khizyuw wa lahum
المشرق والمغرب	al-masyriqu wal-magrib
والمغرب فأينما	wal-magribu fa ainamā
فأينما تولوا	fa ainamā tuwallụ
تولوا فثم	tuwallụ fa ṡamm
فثم وجه	fa ṡamma wajh
واسع عليم	innallāha wāsi’un ‘alīm
وقالوا اتخذ	wa qāluttakhaż
اتخذ الله	attakhażallāh
الله ولدا	allāhu waladā
ولدا سبحانه	waladan sub-ḥānah
له قانتون	kullul lahụ qānitụn
بديع السماوات	badī’us-samāwāti wal-arḍ
وإذا قضى	wa iżā qaḍā
قضى أمرا	qaḍā amrā
أمرا فإنما	amran fa innamā
فإنما يقول	fa innamā yaqụl
يقول له	yaqụlu lah
له كن	lahụ kun
كن فيكون	kun fa yakụn
لولا يكلمنا	lau lā yukallimunā
يكلمنا الله	yukallimunallāh
الله أو	allāhu au
أو تأتينا	au ta`tīnā
تأتينا آية	ta`tīnā āyah
مثل قولهم	miṡla qaulihim
تشابهت قلوبهم	tasyābahat qulụbuhum
لقوم يوقنون	liqaumiy yụqinụn
إنا أرسلناك	innā arsalnāk
أرسلناك بالحق	arsalnāka bil-ḥaq
بالحق بشيرا	bil-ḥaqqi basyīrā
بشيرا ونذيرا	basyīraw wa nażīrā
ونذيرا ولا تسأل	wa nażīraw wa lā tus`al
ولا تسأل	wa lā tus`al
تسأل عن	tus`alu ‘an
عن أصحاب	‘an aṣ-ḥāb
أصحاب الجحيم	aṣ-ḥābil-jaḥīm
ولن ترضى	wa lan tarḍā
ترضى عنك	tarḍā ‘angk
عنك اليهود	‘angkal-yahụd
اليهود ولا	al-yahụdu wa lā
النصارى حتى	an-naṣārā ḥattā
حتى تتبع	ḥattā tattabi’
تتبع ملتهم	tattabi’a millātahum
 هدى الله	hudallāh
هو الهدى	huwal-hudā
ولئن اتبعت	wa la`inittaba’t
اتبعت أهواءهم	attaba’ta ahwā`ahum
بعد الذي	ba’dallażi
الذي جاءك	allażī jā`ak
جاءك من	jā`aka min
من العلم	minal-‘ilm
العلم ما	al-‘ilmi ma
ما لك من	mā laka min
الذين آتيناهم	allażīna ātaināhum
الكتاب يتلونه	al-kitāba yatlụnah
يتلونه حق	yatlụnahụ ḥaq
حق تلاوته	ḥaqqa tilāwatih
ومن يكفر	wa may yakfur
يكفر به	yakfur bihi
به فأولئك	bihī fa ulā`ik
اذكروا نعمتي	użkurụ ni’matī
نعمتي التي	ni’matiyallati
التي أنعمت	allatī an’amt
أنعمت عليكم	an’amtu ‘alaikum
وأني فضلتكم	wa annī faḍḍaltukum
واتقوا يوما	wattaqụ yaumā
يوما لا 	yaumal lā
تجزي نفس	tajzī nafs
نفس عن	nafsun ‘an
نفس شيئا	nafsin syai`ā
شيئا ولا	syai`aw wa lā
ولا يقبل	wa lā yuqbal
يقبل منها	yuqbalu min-hā
منها عدل	min-hā ‘adl
عدل ولا	‘adluw wa lā
ولا تنفعها	wa lā tanfa’uhā
تنفعها شفاعة	tanfa’uhā syafā’ah
شفاعة ولا	syafā’atuw wa lā
وإذ ابتلى	wa iżibtalā
إبراهيم ربه	ibrāhīma rabbuh
ربه بكلمات	rabbuhụ bikalimāt
بكلمات فأتمهن	bikalimātin fa atammahunn
قال إني	qāla innī
إني جاعلك	innī jā’iluk
جاعلك للناس	jā’iluka lin-nās
للناس إماما	lin-nāsi imāmā
ومن ذريتي	qāla wa min żurriyyatī
ينال عهدي 	yanālu ‘ahdī
عهدي الظالمين	‘ahdiẓ-ẓālimīn
جعلنا البيت	wa iż ja’alnal-bait
البيت مثابة	al-baita maṡābah
مثابة للناس	maṡābatal lin-nās
للناس وأمنا	lin-nāsi wa amnā
من مقام	mim maqām
مقام إبراهيم	maqāmi ibrāhīm
إبراهيم مصلى	ibrāhīma muṣallā
وعهدنا إلى	wa ‘ahidnā ilā
إلى إبراهيم	ilā ibrāhīm
إبراهيم وإسماعيل	ibrāhīma wa ismā’īl
وإسماعيل أن	wa ismā’īla an
أن طهرا	an ṭahhira
طهرا بيتي	ṭahhirā baitī
بيتي للطائفين	baitiya liṭ-ṭā`ifīn
للطائفين والعاكفين	liṭ-ṭā`ifīna wal-‘ākifīn
والعاكفين والركع	wal-‘ākifīna war-rukka’
والركع السجود	war-rukka’is-sujụd
رب اجعل	rabbij’al
اجعل هذا	ij’al hāżā
هذا بلدا	hāżā baladā
بلدا آمنا	baladan āminā
آمنا وارزق	āminaw warzuq
وارزق أهله	warzuq ahlah
أهله من	ahlahụ min
من الثمرات	minaṡ-ṡamarāt
الثمرات من	aṡ-ṡamarāti man
من آمن	man āman
آمن منهم	āmana min-hum
منهم بالله	min-hum billāh
بالله واليوم	billāhi wal-yaum
واليوم الآخر	wal-yaumil-ākhir
فأمتعه قليلا	fa umatti’uhụ qalīlā
قليلا ثم	qalīlan ṡum
ثم أضطره	ṡumma aḍṭarruh
أضطره إلى	aḍṭarruhū ilā
إلى عذاب	ilā ‘ażābin-nār
وبئس المصير	wa bi`sal-maṣīr
يرفع إبراهيم	yarfa’u ibrāhīm
إبراهيم القواعد	ibrāhīmul-qawā’id
القواعد من	al-qawā’ida min
من البيت	minal-bait
البيت وإسماعيل	al-baiti wa ismā’īl
تقبل منا	taqabbal minnā
واجعلنا مسلمين	waj’alnā muslimain
مسلمين لك	muslimaini lak
ذريتنا أمة	żurriyyatinā ummah
أمة مسلمة	ummatam muslimah
مسلمة لك	muslimatal lak
لك وأرنا	laka wa arinā
وأرنا مناسكنا	wa arinā manāsikanā
مناسكنا وتب	manāsikanā wa tub
وتب علينا	wa tub ‘alainā
ربنا وابعث	rabbanā wab’aṡ
وابعث فيهم	wab’aṡ fīhim
رسولا منهم	rasụlam min-hum 
يتلو عليهم	yatlụ ‘alaihim
آياتك ويعلمهم	āyātika wa yu’allimuhum
الكتاب والحكمة	al-kitāba wal-ḥikmah
والحكمة ويزكيهم	wal-ḥikmata wa yuzakkīhim
ومن يرغب	wa may yargab
عن ملة	‘am millāh
ملة إبراهيم	millāti ibrāhīm
سفه نفسه	safiha nafsah
ولقد اصطفيناه	wa laqadiṣṭafaināh
أسلمت لرب	iż qāla lahụ rabbuhū aslim qāla aslamtu lirabbil-‘ālamīn
ووصى بها	wa waṣṣā bihā
بها إبراهيم	bihā ibrāhīm
إبراهيم بنيه	ibrāhīmu banīh
بنيه ويعقوب	banīhi wa ya’qụb
فلا تموتن	fa lā tamụtunn
حضر يعقوب	ḥaḍara ya’qụb
وإله آبائك	wa ilāha ābā`ik
أمة قد	ummatung qad
ما كسبتم	mā kasabtum
تسألون عما	tus`alụna ‘ammā
نصارى تهتدوا	naṣārā tahtadụ
إبراهيم حنيفا	ibrāhīma ḥanīfā
أوتي النبيون	ụtiyan-nabiyyụn
أحد منهم	aḥadim min-hum
فقد اهتدوا	fa qadihtadau
في شقاق	fī syiqāq
فسيكفيكهم الله	fa sayakfīkahumullāh
صبغة الله	ṣibgatallāh
صبغة ونحن	ṣibgataw wa naḥn
أتحاجوننا في	a tuḥājjụnanā fī
لنا أعمالنا	lanā a’mālunā
له مخلصون	lahụ mukhliṣụn
ويعقوب والأسباط	wa ya’qụba wal-asbāṭ
أأنتم أعلم	a antum a’lam
كتم شهادة	katama syahādah
بغافل عما	bigāfilin ‘ammā
تلك أمة	tilka ummah
كسبت ولكم	kasabat wa lakum
سيقول السفهاء	sayaqụlus-sufahā`
لله المشرق	lillāhil-masyriq
صراط مستقيم	ṣirāṭim mustaqīm
وسطا لتكونوا	wasaṭal litakụnụ
يتبع الرسول	yattabi’ur-rasụl
كانت لكبيرة	kānat lakabīrah
ليضيع إيمانكم	liyuḍī’a īmānakum
لرءوف رحيم	lara`ụfur raḥīm
تقلب وجهك	taqalluba waj-hik
فلنولينك قبلة	fa lanuwalliyannaka qiblah
شطره لئلا يكون	wa ḥaiṡu mā kuntum fa wallụ wujụhakum syaṭrah
ليعلمون أنه	laya’lamụna annah
ولئن أتيت	wa la`in atait
بتابع قبلتهم	bitābi’ing qiblatahum
بتابع قبلة	bitābi’ing qiblah
العلم إنك	al-‘ilmi innak
يعرفون أبناءهم	ya’rifụna abnā`ahum
ليكتمون الحق	layaktumụnal-ḥaq
من الممترين	minal-mumtarīn
فاستبقوا الخيرات	fastabiqul-khairāt
تكونوا يأت	aina mā takụnụ ya`ti bikumullāhu jamī’ā
خرجت فول	kharajta fa wal
للحق من	wa innahụ lal-ḥaqqu mir rabbik
فول وجهك	fa walli waj-hak
واخشوني ولأتم	wakhsyaunī wa li`utimm
أرسلنا فيكم	arsalnā fīkum
فاذكروني أذكركم	fażkurụnī ażkurkum
آمنوا استعينوا	āmanusta’īnụ
مع الصابرين	ma’aṣ-ṣābirīn
الله أموات	allāhi amwāt
أحياء ولكن	aḥyā`uw wa lākin
والجوع ونقص	wal-jụ’i wa naqṣ
وبشر الصابرين	wa basysyiriṣ-ṣābirīn
أصابتهم مصيبة	aṣābat-hum muṣībah
إليه راجعون	ilaihi rāji’ụn
عليهم صلوات	‘alaihim ṣalawāt
هم المهتدون	humul-muhtadụn
الصفا والمروة	aṣ-ṣafā wal-marwah
حج البيت	ḥajjal-bait
تطوع خيرا	taṭawwa’a khairā
البينات والهدى	al-bayyināti wal-hudā
تابوا وأصلحوا	tābụ wa aṣlaḥụ
وأنا التواب	wa anat-tawwābur-raḥīm
والملائكة والناس	wal-malā`ikati wan-nās
خالدين فيها	khālidīna fīhā
لا يخفف	lā yukhaffaf
وإلهكم إله	wa ilāhukum ilāh
لا إله إلا	lā ilāha illā
والنهار والفلك	wan-nahāri wal-fulk
أندادا يحبونهم	andāday yuḥibbụnahum
أشد حبا	asyaddu ḥubbā
اتبعوا ورأوا	ittaba’ụ wa ra`awụ
كرة فنتبرأ	karratan fa natabarra`
تبرءوا منا	tabarra`ụ minnā
كذلك يريهم	każālika yurīhim
بخارجين من	bikhārijīna min
الناس كلوا	an-nāsu kulụ
عدو مبين	‘aduwwum mubīn
بالسوء والفحشاء	bis-sū`i wal-faḥsyā`
ألفينا عليه	alfainā ‘alaih
يعقلون شيئا	ya’qilụna syai`ā
ينعق بما	yan’iqu bimā
بكم عمي	bukmun ‘umi
رزقناكم واشكروا	razaqnākum wasykurụ
الميتة والدم	al-maitata wad-dam
فمن اضطر	fa maniḍṭur
الكتاب ويشترون	al-kitābi wa yasytarụn
اشتروا الضلالة	asytarawuḍ-ḍalālah
فما أصبرهم	fa mā aṣbarahum
الكتاب بالحق	al-kitāba bil-ḥaqq
لفي شقاق	lafī syiqāq
الآخر والملائكة	al-ākhiri wal-malā`ikah
حبه ذوي	ḥubbihī żawī
أقام الصلاة	aqāmaṣ-ṣalāh
والموفون بعهدهم	wal-mụfụna bi’ahdihim
البأساء والضراء	al-ba`sā`i waḍ-ḍarrā`ụ
الذين صدقوا	allażīna ṣadaqụ
هم المتقون	humul-muttaqụn
عليكم القصاص	‘alaikumul-qiṣāṣ
بالحر والعبد	bil-ḥurri wal-‘abd
فاتباع بالمعروف	fattibā’um bil-ma’rụf
ذلك تخفيف	żālika takhfīf
فمن اعتدى	fa mani’tadā
القصاص حياة	al-qiṣāṣi ḥayāh
حضر أحدكم	ḥaḍara aḥadakum
على المتقين	‘alal-muttaqīn
بدله بعدما	baddalahụ ba’da mā
موص جنفا	mụṣin janafā
كما كتب	kamā kutib
أياما معدودات	ayyāmam ma’dụdāt
سفر فعدة	safarin fa ‘iddah
يطيقونه فدية	yuṭīqụnahụ fidyah
تطوع خيرا	taṭawwa’a khairā
تصوموا خير	taṣụmụ khair
للناس وبينات	lin-nāsi wa bayyināt
الشهر فليصمه	asy-syahra falyaṣum-h
كان مريضا	kāna marīḍā
ولتكملوا العدة	wa litukmilul-‘iddah
سألك عبادي	sa`alaka ‘ibādī
دعوة الداع	da’watad-dā’
الصيام الرفث	aṣ-ṣiyāmir-rafaṡ
لباس لهن	libāsul lahunn
تختانون أنفسكم	takhtānụna anfusakum
باشروهن وابتغوا	bāsyirụhunna wabtagụ
حتى يتبين	ḥattā yatabayyan
أتموا الصيام	atimmuṣ-ṣiyām
ولا تباشروهن	wa lā tubāsyirụhunn
تلك حدود	tilka ḥudụd
آياته للناس	āyātihī lin-nās
الحكام لتأكلوا	al-ḥukkāmi lita`kulụ
يسألونك عن	yas`alụnaka ‘an
مواقيت للناس	mawāqītu lin-nās
بأن تأتوا	bi`an ta`tụ
أبوابها واتقوا	abwābihā wattaqụ
يقاتلونكم ولا	yuqātilụnakum wa lā
يحب المعتدين	yuḥibbul-mu’tadīn
حيث ثقفتموهم	ḥaiṡu ṡaqiftumụhum
يقاتلوكم فيه	yuqātilụkum fīh
قاتلوكم فاقتلوهم	qātalụkum faqtulụhum
كذلك جزاء	każālika jazā`
انتهوا فإن	inintahau fa in
تكون فتنة	takụna fitnah
فلا عدوان	fa lā ‘udwān
والحرمات قصاص	wal-ḥurumātu qiṣāṣ
بمثل ما اعتدى	bimiṡli ma’tadā
إلى التهلكة	ilat-tahlukah
وأتموا الحج	wa atimmul-ḥajj
فما استيسر	fa mastaisar
الهدي محله	al-hadyu maḥillāh
أو به أذى	au bihī ażā
فإذا أمنتم	fa iżā amintum
تمتع بالعمرة	tamatta’a bil-‘umrah
فصيام ثلاثة	fa ṣiyāmu ṡalāṡah
عشرة كاملة	‘asyaratung kāmilah
أهله حاضري	ahluhụ ḥāḍirī
شديد العقاب	syadīdul-‘iqāb
أشهر معلومات	asy-hurum ma’lụmāt
فرض فيهن	faraḍa fīhinn
خير يعلمه	khairiy ya’lam-h
الزاد التقوى	az-zādit-taqwā
تبتغوا فضلا	abtagụ faḍlā
عرفات فاذكروا	‘arafātin fażkurụ
لمن الضالين	laminaḍ-ḍāllīn
حيث أفاض	ḥaiṡu afāḍ
قضيتم مناسككم	qaḍaitum manasikakum
يقول ربنا 	yaqụlu rabbanā
حسنة وقنا	ḥasanataw wa qinā
مما كسبوا	mimmā kasabụ
أيام معدودات	ayyāmim ma’dụdāt
تعجل في	ta’ajjala fī
تأخر فلا	ta`akhkhara fa lā
واعلموا أنكم	wa’lamū annakum
يعجبك قوله	yu’jibuka qauluh
الحرث والنسل	al-ḥarṡa wan-nasl
يحب الفساد	yuḥibbul-fasād
أخذته العزة	akhażat-hul-‘izzah
ولبئس المهاد	wa labi`sal-mihād
يشري نفسه	yasyrī nafsah
رءوف بالعباد	ra`ụfum bil-‘ibād
تتبعوا خطوات	tattabi’ụ khuṭuwāt
فإن زللتم	fa in zalaltum
الغمام والملائكة	al-gamāmi wal-malā`ikah
ترجع الأمور	turja’ul-umụr
إسرائيل كم	isrā`īla kam
يبدل نعمة	yubaddil ni’mah
الدنيا ويسخرون	ad-dun-yā wa yaskharụn
يشاء بغير	yasyā`u bigair
أمة واحدة	ummataw wāḥidah
النبيين مبشرين	an-nabiyyīna mubasysyirīn
جاءتهم البينات	jā`at-humul-bayyināt
الحق بإذنه	al-ḥaqqi bi`iżnih
إلى صراط	ilā ṣirāṭ
يأتكم مثل	ya`tikum maṡal
والضراء وزلزلوا	waḍ-ḍarrā`u wa zulzilụ
إن نصر	inna naṣr
يسألونك ماذا	yas`alụnaka māżā
فللوالدين والأقربين	fa lil-wālidaini wal-aqrabīn
تفعلوا من	taf’alụ min
القتال وهو	al-qitālu wa hụ
تكرهوا شيئا	takrahụ syai`a
تحبوا شيئا	tuḥibbụ syai`a
يعلم وأنتم	ya’lamu wa antum
الحرام قتال	al-ḥarāmi qitāl
فيه كبير	fīhi kabīr
إخراج أهله	ikhrāju ahlih
والفتنة أكبر	wal-fitnatu akbar
إن استطاعوا	inistaṭā’ụ
دينه فيمت	dīnihī fa yamut
يرجون رحمت	yarjụna raḥmat
الخمر والميسر	al-khamri wal-maisir
ومنافع للناس	wa manafi’u lin-nās
ويسألونك ماذا	wa yas`alụnaka māżā
قل العفو	qulil-‘afụ
الآيات لعلكم	al-āyāti la’allakum
عن اليتامى	‘anil-yatāmā
قل إصلاح	qul iṣlāḥ
تخالطوهم فإخوانكم	tukhāliṭụhum fa ikhwānukum
يعلم المفسد	ya’lamul-mufsid
الله لأعنتكم	allāhu la`a’natakum
تنكحوا المشركات	tangkiḥul-musyrikāt
مشركة ولو	musyrikatiw walau
تنكحوا المشركين	tungkiḥul-musyrikīn
ولعبد مؤمن 	wa la’abdum mu`min
والمغفرة بإذنه	wal-magfirati bi`iżnih
ويبين آياته	wa yubayyinu āyātih
عن المحيض	‘anil-maḥīḍ
أذى فاعتزلوا	ażan fa’tazilụ
تطهرن فأتوهن	taṭahharna fa`tụhunn
التوابين ويحب	at-tawwābīna wa yuḥibb
شئتم وقدموا	syi`tum wa qaddimụ
أنكم ملاقوه	annakum mulāqụh
وبشر المؤمنين	wa basysyiril-mu`minīn
عرضة لأيمانكم	‘urḍatal li`aimānikum
الله باللغو	allāhu bil-lagụ
نسائهم تربص	nisā`ihim tarabbuṣ
عزموا الطلاق	‘azamuṭ-ṭalāq
والمطلقات يتربصن	wal-muṭallaqātu yatarabbaṣn
في أرحامهن	 fī ar-ḥāmihinn
أحق بردهن	aḥaqqu biraddihinn
بالمعروف وللرجال	bil-ma’rụfi wa lir-rijāl
تسريح بإحسان	tasrīḥum bi`iḥsān
ألا يقيما	allā yuqīmā
 فيما افتدت به	fīmaftadat bih
فلا تعتدوها	fa lā ta’tadụhā
يتعد حدود	yata’adda ḥudụd
تنكح زوجا	tangkiḥa zaujā
يقيما حدود	yuqīmā ḥudụd
يبينها لقوم	yubayyinuhā liqaum
فبلغن أجلهن	fa balagna ajalahunn
ضرارا لتعتدوا	ḍirāral lita’tadụ
ظلم نفسه	ẓalama nafsah
والحكمة يعظكم	wal-ḥikmati ya’iẓukum
واعلموا أن	wa’lamū an
ينكحن أزواجهن 	yangkiḥna azwājahun
يوعظ به 	yụ’aẓu bih
ذلكم أزكى	żālikum azkā
والوالدات يرضعن	wal-wālidātu yurḍi’n
رزقهن وكسوتهن	rizquhunna wa kiswatuhun
تكلف نفس	tukallafu nafs
لا تضار والدة	lā tuḍārra wālidah
أرادا فصالا	arādā fiṣālā
 تسترضعوا أولادكم	tastarḍi’ū aulādakum
بأنفسهن أربعة	bi`anfusihinna arba’ah
أنفسهن بالمعروف	anfusihinna bil-ma’rụf
خطبة النساء	khiṭbatin-nisā`
ستذكرونهن ولكن	satażkurụnahunna wa lākin
تعزموا عقدة	ta’zimụ ‘uqdah
أنفسكم فاحذروه	anfusikum faḥżarụh
 تمسوهن أو تفرضوا	tamassụhunna au tafriḍụ
متاعا بالمعروف	matā’am bil-ma’rụf
على المحسنين	‘alal-muḥsinīn
 فريضة فنصف	farīḍatan fa niṣf
تعفوا أقرب	ta’fū aqrab
تنسوا الفضل	tansawul-faḍl
الصلوات والصلاة	aṣ-ṣalawāti waṣ-ṣalāh
فرجالا أو ركبانا	fa rijālan au rukbānā
أمنتم فاذكروا	amintum fażkurụ
أزواجا وصية	azwājaw waṣiyyah
خرجن فلا	kharajna fa lā
وللمطلقات متاع	wa lil-muṭallaqāti matā’
كذلك يبين	każālika yubayyin
الموت فقال	al-mauti fa qāl
ثم أحياهم	ṡumma aḥyāhum
لذو فضل	lażụ faḍl
حسنا فيضاعفه	ḥasanan fa yuḍā’ifah
يقبض ويبسط	yaqbiḍu wa yabṣuṭ
تر إلى الملإ	tara ilal-mala`
ملكا نقاتل	malikan-nuqātil
القتال ألا	al-qitālu allā
ديارنا وأبنائنا	diyārinā wa abnā`inā
القتال تولوا	al-qitālu tawallau
طالوت ملكا	ṭālụta malikā
يؤت سعة	yu`ta sa’ah
الله اصطفاه	allāhaṣṭafāh
يؤتي ملكه	yu`tī mulkah
يأتيكم التابوت	ya`tiyakumut-tābụt
ذلك لآية	 żālika la`āyat
مبتليكم بنهر	mubtalīkum binahar
فليس مني	fa laisa minnī
اغترف غرفة	igtarafa gurfah
فشربوا منه	fa syaribụ min-h
اليوم بجالوت	al-yauma bijālụt
قليلة غلبت	qalīlatin galabat
وثبت أقدامنا	wa ṡabbit aqdāmanā
فهزموهم بإذن	fa hazamụhum bi`iżn
داوود جالوت	dāwụdu jālụt
ببعض لفسدت	biba’ḍil lafasadat
نتلوها عليك	natlụhā ‘alaik
لمن المرسلين	laminal-mursalīn
الرسل فضلنا	ar-rusulu faḍḍalnā
ورفع بعضهم	wa rafa’a ba’ḍahum
البينات وأيدناه	al-bayyināti wa ayyadnāh
ما اقتتل	maqtatal
خلة ولا شفاعة	khullatuw wa lā syafā’ah
والكافرون هم	wal-kāfirụna hum
الحي القيوم	al-ḥayyul-qayyụm
تأخذه سنة	ta`khużuhụ sinah
السماوات وما	as-samāwāti wa mā
يشفع عنده	yasyfa’u ‘indah
بين أيديهم	baina aidīhim
يحيطون بشيء	yuḥīṭụna bisyai`
وسع كرسيه	wasi’a kursiyyuh
يئوده حفظهما	ya`ụduhụ ḥifẓuhumā
لا إكراه	lā ikrāh
قد تبين الرشد	qat tabayyanar-rusyd
فقد استمسك	fa qadistamsak
يخرجهم من الظلمات	yukhrijuhum minaẓ-ẓulumāt
أولياؤهم الطاغوت	auliyā`uhumuṭ-ṭāgụt
ربه أن آتاه	rabbihī an ātāh
ربي الذي يحيي	rabbiyallażī yuḥyī
المشرق فأت بها	al-masyriqi fa`ti bihā
وهي خاوية	wa hiya khāwiyah
يحيي هذه	yuḥyī hāżih
ثم بعثه	ṡumma ba’aṡah
قال كم لبثت	qāla kam labiṡt
لبثت يوما	labiṡtu yaumā
لبثت مائة	labiṡta mi`ah
إلى حمارك	ilā ḥimārik
كيف ننشزها	kaifa nunsyizuhā
فلما تبين له 	fa lammā tabayyana lah
رب أرني كيف	rabbi arinī kaif
أولم تؤمن	a wa lam tu`min
ليطمئن قلبي	liyaṭma`inna qalbī
ثم ادعهن	ṡummad’uhun
حبة أنبتت	ḥabbatin ambatat
يضاعف لمن	yuḍā’ifu liman
أذى لهم	ażal lahum
معروف ومغفرة	ma’rụfuw wa magfirah
لا تبطلوا صدقاتكم	lā tubṭilụ ṣadaqātikum
فتركه صلدا	fa tarakahụ ṣaldā
لا يقدرون على	lā yaqdirụna ‘alā
يهدي القوم	yahdil-qaum
بربوة أصابها	birabwatin aṣābahā
وابل فطل	wābilun fa ṭall
نخيل وأعناب	nakhīliw wa a’nāb
نار فاحترقت	nārun faḥtaraqat
الآيات لعلكم تتفكرون	al-āyāti la’allakum tatafakkarụn
طيبات ما كسبتم	ṭayyibāti mā kasabtum
تيمموا الخبيث منه	tayammamul-khabīṡa min-h
غني حميد	ganiyyun ḥamīd
الفقر ويأمركم	al-faqra wa ya`murukum
يعدكم مغفرة	ya’idukum magfirah
يؤتي الحكمة	yu`til-ḥikmah
يؤت الحكمة فقد	yu`tal-ḥikmata fa qad
أولو الألباب	ulul-albāb
نفقة أو نذرتم	nafaqatin au nażartum
للظالمين من أنصار	liẓ-ẓālimīna min anṣār
وتؤتوها الفقراء	wa tu`tụhal-fuqarā`
عنكم من سيئاتكم	‘angkum min sayyi`ātikum
عليك هداهم	‘alaika hudāhum
خير فلأنفسكم	khairin fa li`anfusikum
تنفقون إلا ابتغاء	tunfiqụna illābtigā`
يوف إليكم	yuwaffa ilaikum
الجاهل أغنياء	al-jāhilu agniyā`
تعرفهم بسيماهم	ta’rifuhum bisīmāhum
الناس إلحافا	an-nāsa il-ḥāfā
سرا وعلانية	sirraw wa ‘alāniyah
من المس	minal-mass
البيع مثل	al-bai’u miṡl
وحرم الربا	wa ḥarramar-ribā
فانتهى فله	fantahā fa lah
وأمره إلى الله	wa amruhū ilallāh
عاد فأولئك	‘āda fa ulā`ik
ويربي الصدقات	wa yurbiṣ-ṣadaqāt
كفار أثيم	kaffārin aṡīm
الصالحات وأقاموا	aṣ-ṣāliḥāti wa aqāmụ
وذروا ما بقي	wa żarụ mā baqi
فأذنوا بحرب	fa`żanụ biḥarb
تبتم فلكم رءوس	tubtum fa lakum ru`ụs
عسرة فنظرة	‘usratin fa naẓirah
تصدقوا خير	taṣaddaqụ khair
ترجعون فيه	turja’ụna fīh
ثم توفى كل	ṡumma tuwaffā kull
تداينتم بدين	tadāyantum bidain
يأب كاتب	ya`ba kātib
الحق وليتق	al-ḥaqqu walyattaq
سفيها أو ضعيفا	safīhan au ḍa’īfā
واستشهدوا شهيدين	wastasy-hidụ syahīdain
فرجل وامرأتان	fa rajuluw wamra`atān
يأب الشهداء	ya`basy-syuhadā`
تكتبوه صغيرا	taktubụhu ṣagīrā
حاضرة تديرونها	ḥāḍiratan tudīrụnahā
يضار كاتب	 yuḍārra kātib
تفعلوا فإنه	taf’alụ fa innah
واتقوا الله	wattaqullāh
ويعلمكم الله	wa yu’allimukumullāh
فرهان مقبوضة	fa rihānum maqbụḍah
بعضا فليؤد	ba’ḍan falyu`ad
تكتموا الشهادة	taktumusy-syahādah
آثم قلبه	āṡimung qalbuh
تخفوه يحاسبكم	tukhfụhu yuḥāsibkum
يشاء ويعذب	yasyā`u wa yu’ażżib
ربه والمؤمنون	rabbihī wal-mu`minụn
وكتبه ورسله	wa kutubihī wa rusulih
نفرق بين	nufarriqu bain
وأطعنا غفرانك	wa aṭa’nā gufrānak
لا يكلف	lā yukallif
ما اكتسبت	maktasabat
أو أخطأنا	au akhṭa`nā
إصرا كما حملته	iṣrang kamā ḥamaltah
لا طاقة لنا	lā ṭāqata lanā
واعف عنا	wa’fu ‘annā
واغفر لنا	wagfir lanā
وارحمنا	war-ḥamnā
مولانا فانصرنا	maulānā fanṣurnā
التوراة والإنجيل	at-taurāta wal-injīl
وأنزل الفرقان	wa anzalal-furqān
كفروا بآيات	kafarụ bi`āyāt
عزيز ذو انتقام	‘azīzun żuntiqām
يخفى عليه	yakhfā ‘alaih
يصوركم في الأرحام	yuṣawwirukum fil-ar-ḥām
وأخر متشابهات	wa ukharu mutasyābihāt
زيغ فيتبعون	zaigun fayattabi’ụn
يعلم تأويله	]ya’lamu ta`wīlah
والراسخون	war-rāsikhụn
هديتنا وهب	hadaitanā wa hab
جامع الناس	jāmi’un-nās
يخلف الميعاد	yukhliful-mī’ād
تغني عنهم	tugniya ‘an-hum
وقود النار	waqụdun-nār
كدأب آل	kada`bi āl
كذبوا بآياتنا	każżabụ bi`āyātinā
بذنوبهم	biżunụbihim
شديد	syadīd
ستغلبون وتحشرون	satuglabụna wa tuḥsyarụn
وبئس المهاد	wa bi`sal-mihād
فئتين التقتا	fi`atainiltaqatā
رأي العين	ra`yal-‘aīn
يؤيد بنصره	yu`ayyidu binaṣrih
لأولي الأبصار	li`ulil-abṣār
والفضة والخيل	wal-fiḍḍati wal-khail
متاع الحياة	matā’ul-ḥayāh
حسن المآب	ḥusnul-ma`āb
أؤنبئكم بخير	a unabbi`ukum bikhair
وأزواج مطهرة	wa azwājum muṭahharah
بالعباد	bil-‘ibād
إننا آمنا	innanā āmannā
والمستغفرين بالأسحار	wal-mustagfirīna bil-as-ḥār
قائما بالقسط	qā`imam bil-qisṭ
الدين عند	ad-dīna ‘ind
بغيا بينهم	bagyam bainahum
يكفر بآيات	yakfur bi`āyāt
ومن اتبعن	 wa manittaba’an
والأميين أأسلمتم	wal-ummiyyīna a aslamtum
فقد اهتدوا	fa qadihtadau
عليك البلاغ	‘alaikal-balāg
يأمرون بالقسط	ya`murụna bil-qisṭ
من ناصرين	min nāṣirīn
أوتوا نصيبا	ụtụ naṣībā
معدودات وغرهم	ma’dụdātiw wa garrahum
جمعناهم ليوم	jama’nāhum liyaum
ووفيت كل	wa wuffiyat kull
وتنزع الملك	wa tanzi’ul-mulk
بيدك الخير	biyadikal-khaīr
وتخرج الميت	wa tukhrijul-mayyit
يتخذ المؤمنون	yattakhiżil-mu`minụn
منهم تقاة	min-hum tuqāh
ويحذركم	wa yuḥażżirukum
صدوركم أو تبدوه	ṣudụrikum au tubdụh
خير محضرا 	khairim muḥḍarā
أمدا بعيدا	amadam ba’īdā
الله نفسه	allāhu nafsah
رءوف	ra`ụf
فاتبعوني يحببكم	fattabi’ụnī yuḥbibkum
قل أطيعوا	qul aṭī’ụ
تولوا فإن	tawallau fa in
ذرية بعضها	żurriyyatam ba’ḍuhā
امرأت عمران	imra`atu ‘imrān
وضعتها أنثى	waḍa’tuhā unṡā
بما وضعت	bimā waḍa’at
الذكر كالأنثى	aż-żakaru kal-unṡā
أعيذها بك	u’īżuhā bik
بقبول حسن	biqabụlin ḥasan
زكريا المحراب	zakariyyal-miḥrāb
مريم أنى لك	maryamu annā lak
قالت هو	qālat hụ
بغير حساب	bigairi ḥisāb
دعا زكريا	da’ā zakariyyā
ذرية طيبة	żurriyyatan ṭayyibah
سميع الدعاء	samī’ud-du’ā`
قائم يصلي	qā`imuy yuṣallī
وامرأتي عاقر	wamra`atī ‘āqir
يفعل ما يشاء	yaf’alu mā yasyā`
لي آية	lī āyah
إلا رمزا	illā ramzā
بالعشي والإبكار	bil-‘asyiyyi wal-ibkār
وطهرك واصطفاك	wa ṭahharaki waṣṭafāk
مريم اقنتي	maryamuqnutī
أنباء الغيب	ambā`il-gaib
يكفل مريم	yakfulu maryam
يبشرك بكلمة	yubasysyiruki bikalimah
المهد وكهلا	al-mahdi wa kahlā
يمسسني بشر	yamsasnī basyar
والتوراة والإنجيل	wat-taurāta wal-injīl
الطين كهيئة	aṭ-ṭīni kahai`ah
الأكمه والأبرص	al-akmaha wal-abraṣ
بما تأكلون	bimā ta`kulụn
التوراة ولأحل	at-taurāti wa li`uḥill
الله وأطيعون	allāha wa aṭī’ụn
ربي وربكم	rabbī wa rabbukum
هذا صراط	hāżā ṣirāṭ
أحس عيسى	aḥassa ‘īsā
الحواريون نحن	al-ḥawāriyyụna naḥn
آمنا بالله	āmannā billāh
واشهد بأنا	wasy-had bi`annā
أنزلت واتبعنا	anzalta wattaba’nā 
ومكروا ومكر	wa makarụ wa makar
خير الماكرين	khairul-mākirīn
متوفيك ورافعك	mutawaffīka wa rāfi’uk
إلي مرجعكم	ilayya marji’ukum
كفروا فأعذبهم	kafarụ fa u’ażżibuhum
الصالحات فيوفيهم	aṣ-ṣāliḥāti fa yuwaffīhim
ذلك نتلوه	żālika natlụh
كمثل آدم	kamaṡali ādam
تراب ثم	turābin ṡumm
تعالوا ندع	ta’ālau nad’
نبتهل فنجعل	nabtahil fa naj’al
لهو القصص	inna hāżā lahuwal-qaṣaṣul-ḥaqq
عليم بالمفسدين	‘alīmum bil-mufsidīn
بعضا أربابا	ba’ḍan arbābā
فقولوا اشهدوا	fa qụlusy-hadụ
أنزلت التوراة	unzilatit-taurāh
هؤلاء حاججتم	hā`ulā`i ḥājajtum
يهوديا ولا نصرانيا	yahụdiyyaw wa lā naṣrāniyya
للذين اتبعوه	lallażīnattaba’ụh
ولي المؤمنين	waliyyul-mu`minīn
ودت طائفة	waddaṭ ṭā`ifah
يضلون إلا	yuḍillụna illā
تكفرون بآيات	takfurụna bi`āyāt
الحق بالباطل	al-ḥaqqa bil-bāṭil
وقالت طائفة	wa qālaṭ ṭā`ifah
تبع دينكم	tabi’a dīnakum
يؤتى أحد	yu`tā aḥad
الفضل بيد	al-faḍla biyad
يؤتيه من يشاء	yu`tīhi may yasyā`
تأمنه بقنطار	ta`man-hu biqinṭār
تأمنه بدينار	ta`man-hu bidīnār
الأميين سبيل	al-ummiyyīna sabīl
الكذب وهم	al-każiba wa hum
بعهده واتقى	bi’ahdihī wattaqā
يشترون بعهد	yasytarụna bi’ahd
يلوون ألسنتهم	yalwụna alsinatahum
والحكم والنبوة	wal-ḥukma wan-nubuwwah
يأمركم أن تتخذوا	ya`murakum an tattakhiżụ
بالكفر بعد	bil-kufri ba’d
لتؤمنن به	latu`minunna bih
ذلكم إصري	żālikum iṣrī
قالوا أقررنا	qālū aqrarnā
فاشهدوا وأنا	fasy-hadụ wa anā
تولى بعد	tawallā ba’d
أفغير دين	a fa gaira dīn
وعيسى والنبيون	wa ‘īsā wan-nabiyyụn
يبتغ غير	yabtagi gair
وجاءهم البينات	wa jā`ahumul-bayyināt
والناس أجمعين	wan-nāsi ajma’īn
عنهم العذاب	‘an-humul-‘ażāb
ذلك وأصلحوا	żālika wa aṣlaḥụ
لن تقبل توبتهم	lan tuqbala taubatuhum
ولو افتدى به	wa lawiftadā bih
لن تنالوا البر	lan tanālul-birr
وما تنفقوا	wa mā tunfiqụ
أن تنزل التوراة	an tunazzalat-taurāh
فأتوا بالتوراة	fa`tụ bit-taurāh
فمن افترى	fa maniftarā
صدق الله	ṣadaqallāh
فاتبعوا ملة	fattabi’ụ millāh
ببكة مباركا	bibakkata mubārak
من دخله	man dakhalah
استطاع إليه	istaṭā’a ilaih
غني عن العالمين	ganiyyun ‘anil-‘ālamīn
لم تكفرون بآيات	lima takfurụna bi`āyāt
تبغونها عوجا	tabgụnahā ‘iwajā
تطيعوا فريقا	tuṭī’ụ farīqā
تتلى عليكم	tutlā ‘alaikum
يعتصم بالله	ya’taṣim billāh
حق تقاته	ḥaqqa tuqātih
واعتصموا بحبل	wa’taṣimụ biḥabl
شفا حفرة	syafā ḥufrah
لكم آياته	lakum āyātih
بالمعروف وينهون	bil-ma’rụfi wa yan-haun
تفرقوا واختلفوا	tafarraqụ wakhtalafụ
وتسود وجوه	wa taswaddu wujụh
الذين اسودت	allażīnaswaddat
فذوقوا العذاب	fa żụqul-‘ażāb
ففي رحمة الله	fa fī raḥmatillāh
آيات الله نتلوها	āyātullāhi natlụhā
ظلما للعالمين	ẓulmal lil-‘ālamīn
أخرجت للناس	ukhrijat lin-nās
لكان خيرا	lakāna khairā
وأكثرهم الفاسقون	wa akṡaruhumul-fāsiqụn
يضروكم إلا أذى	yaḍurrụkum illā ażā
يولوكم الأدبار	yuwallụkumul-adbār
ثم لا ينصرون	ṡumma lā yunṣarụn
الأنبياء بغير حق	al-ambiyā`a bigairi ḥaqq
ليسوا سواء	laisụ sawā`ā
أمة قائمة	ummatung qā`imah
يسارعون في الخيرات	yusāri’ụna fil-khairāt
من الصالحين	minaṣ-ṣāliḥīn
فلن يكفروه	fa lay yukfarụh
أموالهم ولا أولادهم	amwāluhum wa lā aulāduhum
صر أصابت حرث	ṣirrun aṣābat ḥarṡ
تتخذوا بطانة	tattakhiżụ biṭānah
ودوا ما عنتم	waddụ mā ‘anittum
بدت البغضاء	badatil-bagḍā`
قد بينا لكم	qad bayyannā lakum
يحبونكم وتؤمنون	yuḥibbụnakum wa tu`minụn
وإذا خلوا عضوا	wa iżā khalau ‘aḍḍụ
حسنة تسؤهم	ḥasanatun tasu`hum
تصبروا وتتقوا	taṣbirụ wa tattaqụ
مقاعد للقتال	maqā’ida lil-qitāl
إذ همت طائفتان	iż hammaṭ ṭā`ifatān
ببدر وأنتم أذلة	bibadriw wa antum ażillāh
ألن يكفيكم	a lay yakfiyakum
الملائكة مسومين	al-malā`ikati musawwimīn
ولتطمئن قلوبكم	wa litaṭma`inna qulụbukum
فينقلبوا خائبين	fa yangqalibụ khā`ibīn
الأمر شيء أو يتوب	al-amri syai`un au yatụb
أضعافا مضاعفة	aḍ’āfam muḍā’afah
والرسول لعلكم	war-rasụla la’allakum
وجنة عرضها	wa jannatin ‘arḍuhā
والكاظمين الغيظ	wal-kāẓimīnal-gaiẓ
ولم يصروا	wa lam yuṣirrụ
وجنات تجري	wa jannātun tajrī
ونعم أجر العاملين	wa ni’ma ajrul-‘āmilīn
سنن فسيروا	sunanun fa sīrụ
هذا بيان	hāżā bayān
وأنتم الأعلون	wa antumul-a’laun
إن يمسسكم قرح	iy yamsaskum qar-ḥ
الأيام نداولها	al-ayyāmu nudāwiluhā
ويتخذ منكم	wa yattakhiża mingkum
وليمحص الله	wa liyumaḥḥiṣallāh
جاهدوا منكم	jāhadụ mingkum
أن تلقوه فقد	an talqauhu fa qad
محمد إلا	muḥammadun illā
قبله الرسل	qablihir-rusul
أو قتل انقلبتم	au qutilangqalabtum
ومن ينقلب	wa may yangqalib
وسيجزي الله	wa sayajzillāh
كتابا مؤجلا	kitābam mu`ajjalā
يرد ثواب	yurid ṡawāb
نؤته منها	nu`tihī min-hā
وسنجزي الشاكرين	wa sanajzisy-syākirīn
وكأين من	wa ka`ayyim min
وما استكانوا	wa mastakānụ
أمرنا وثبت	amrinā wa ṡabbit
فآتاهم الله	fa ātāhumullāh
أعقابكم فتنقلبوا	a’qābikum fa tangqalibụ
بل الله مولاكم	balillāhu maulākum
خير الناصرين	khairun nāṣirīn
كفروا الرعب بما	kafarur-ru’ba bimā
ومأواهم النار	wa ma`wāhumun-nār
مثوى الظالمين	maṡwaẓ-ẓālimīn
إذ تحسونهم بإذن	iż taḥussụnahum bi`iżn
الأمر وعصيتم	al-amri wa ‘aṣaitum
ثم صرفكم	ṡumma ṣarafakum ‘an-hum liyabtaliyakum
عفا عنكم	‘afā ‘angkum
فأثابكم غما بغم	fa aṡābakum gammam bigamm
وطائفة قد أهمتهم	 ṭā`ifatung qad ahammat-hum
إن الأمر كله	innal-amra kullah
يبدون لك	yubdụna lak
قتلنا هاهنا	qutilnā hāhunā
لبرز الذين	labarazallażīn
صدوركم وليمحص	ṣudụrikum wa liyumaḥḥiṣ
إنما استزلهم	innamastazallahum
عفا الله	‘afallāh
غزى لو كانوا	guzzal lau kānụ
حسرة في قلوبهم	ḥasratan fī qulụbihim
يحيي ويميت	yuḥyī wa yumīt
أو متم لمغفرة	au muttum lamagfirah
قتلتم لإلى الله	qutiltum la`ilallāh
فظا غليظ القلب	faẓẓan galīẓal-qalb
عزمت فتوكل	‘azamta fa tawakkal
إن ينصركم الله	iy yanṣurkumullāh
يخذلكم فمن ذا الذي	yakhżulkum fa man żallażī
فليتوكل المؤمنون	falyatawakkalil-mu`minụn
لنبي أن يغل	linabiyyin ay yagull
يغلل يأت	yaglul ya`t
ثم توفى كل	ṡumma tuwaffā kul
أفمن اتبع رضوان	a fa manittaba’a riḍwān
درجات عند	darajātun ‘ind
آياته ويزكيهم	 āyātihī wa yuzakkīhim
لفي ضلال مبين	lafī ḍalālim mubīn
مصيبة قد أصبتم	muṣībatung qad aṣabtum
عند أنفسكم	‘indi anfusikum
فبإذن الله	fa bi`iżnillāh
أو ادفعوا	awidfa’ụ
قتالا لاتبعناكم	qitālal lattaba’nākum
أقرب منهم	aqrabu min-hum
يقولون بأفواههم	yaqụlụna bi`afwāhihim
أعلم بما يكتمون	 a’lamu bimā yaktumụn
أطاعونا ما قتلوا	aṭā’ụnā mā qutilụ
فادرءوا	fadra`ụ
تحسبن الذين	taḥsabannallażīn
أحياء عند	aḥyā`un ‘ind
آتاهم الله	ātāhumullāh
يستبشرون بنعمة	yastabsyirụna bini’mah
الذين استجابوا لله	allażīnastajābụ lillāh
فاخشوهم فزادهم	fakhsyauhum fa zādahum
سوء واتبعوا	sū`uw wattaba’ụ
ذو فضل عظيم	żụ faḍlin ‘aẓīm
تخافوهم وخافون	takhāfụhum wa khāfụn
يحزنك الذين	yaḥzungkallażīn
لن يضروا الله	lay yaḍurrullāh
حظا في الآخرة	ḥaẓẓan fil-ākhirah
الذين اشتروا الكفر	allażīnasytarawul-kufr
أنما نملي	annamā numlī
ليزدادوا إثما	liyazdādū iṡmā
يميز الخبيث	yamīzal-khabīṡ
ليطلعكم	liyuṭli’akum
وتتقوا فلكم	wa tattaqụ fa lakum
هو شر لهم	huwa syarrul lahum
سيطوقون	sayuṭawwaqụn
ميراث السماوات	mīrāṡus-samāwāt
ونحن أغنياء	wa naḥnu agniyā`
وقتلهم الأنبياء	wa qatlahumul-ambiyā`
بظلام للعبيد	biẓallāmil lil-‘abīd
بقربان تأكله النار	biqurbānin ta`kuluhun-nār
وبالذي قلتم	wa billāżī qultum
جاءوا بالبينات	jā`ụ bil-bayyināt
نفس ذائقة	nafsin żā`iqah
توفون أجوركم	tuwaffauna ujụrakum
زحزح عن النار	zuḥziḥa ‘anin-nār
متاع الغرور	matā’ul-gurụr
لتبلون في	latublawunna fī
أشركوا أذى	asyrakū ażā
وتتقوا فإن	wa tattaqụ fa in
لتبيننه للناس	latubayyinunnahụ lin-nās
فبئس ما يشترون	fa bi`sa mā yasytarụn
تحسبنهم بمفازة	taḥsabannahum bimafāzh
قياما وقعودا	qiyāmaw wa qu’ụdā
خلقت هذا	khalaqta hāżā
سبحانك فقنا	sub-ḥānaka fa qinā
فقد أخزيته	fa qad akhzaitah
مناديا ينادي	munādiyay yunādī
آتنا ما وعدتنا	ātinā mā wa’attanā
 تخلف الميعاد	tukhliful-mī’ād
عمل عامل	‘amala ‘āmil
بعضكم من بعض	ba’ḍukum mim ba’ḍ
وقاتلوا وقتلوا	wa qātalụ wa qutilụ
ثوابا من	ṡawābam min
حسن الثواب	ḥusnuṡ-ṡawāb
يغرنك تقلب	yagurrannaka taqallub
متاع قليل	matā’ung qalīl
ثم مأواهم جهنم	ṡumma ma`wāhum jahannam
جنات تجري من	jannātun tajrī min
خير للأبرار	khairul lil-abrār
يشترون بآيات	yasytarụna bi`āyāt
أولئك لهم	ulā`ika lahum
سريع الحساب	sarī’ul-ḥisāb
آمنوا اصبروا	āmanuṣbirụ
رجالا كثيرا ونساء	rijālang kaṡīraw wa nisā`
به والأرحام	bihī wal-ar-ḥām
عليكم رقيبا	‘alaikum raqībā
تتبدلوا الخبيث	tatabaddalul-khabīṡ
حوبا كبيرا	ḥụbang kabīrā
فانكحوا ما طاب	fangkiḥụ mā ṭāb
تعدلوا فواحدة	ta’dilụ fa wāḥidah
ذلك أدنى	żālika adnā
صدقاتهن نحلة	ṣaduqātihinna niḥlah
هنيئا مريئا	hanī`am marī`ā
تؤتوا السفهاء	tu`tus-sufahā`
بلغوا النكاح	balagun-nikāḥ
رشدا فادفعوا	rusydan fadfa’ū
إسرافا وبدارا	isrāfaw wa bidārā
غنيا فليستعفف	ganiyyan falyasta’fif
فقيرا فليأكل	faqīran falya`kul
أموالهم فأشهدوا	amwālahum fa asy-hidụ
ترك الوالدان	tarakal-wālidān
نصيبا مفروضا	naṣībam mafrụḍā
حضر القسمة	ḥaḍaral-qismah
ضعافا خافوا	ḍi’āfan khāfụ
أموال اليتامى	amwālal-yatāmā
وسيصلون سعيرا	wa sayaṣlauna sa’īrā
حظ الأنثيين	ḥaẓẓil-unṡayaīn
فوق اثنتين	fauqaṡnatain
فلها النصف	fa lahan-niṣf
منهما السدس	min-humas-sudus
فلأمه الثلث	fa li`ummihiṡ-ṡuluṡ
إخوة فلأمه	ikhwatun fa li`ummih
آباؤكم وأبناؤكم	ābā`ukum wa abnā`ukum
تدرون أيهم	tadrụna ayyuhum
فريضة من الله	farīḍatam minallāh
ترك أزواجكم	taraka azwājukum
وصية يوصين	waṣiyyatiy yụṣīn
ولهن الربع	wa lahunnar-rubu’
فلهن الثمن	fa lahunnaṡ-ṡumun
رجل يورث كلالة	rajuluy yụraṡu kalālah
غير مضار	gaira muḍārr
وصية من الله	waṣiyyatam minallāh
تلك حدود الله	tilka ḥudụdullāh
يدخله جنات	yudkhil-hu jannāt
ويتعد حدوده	wa yata’adda ḥudụdah
واللاتي يأتين الفاحشة	wallātī ya`tīnal-fāḥisyah
فأمسكوهن في	fa amsikụhunna fī
واللذان يأتيانها	wallażāni ya`tiyānihā
وأصلحا فأعرضوا	wa aṣlaḥā fa a’riḍụ
توابا رحيما	tawwābar raḥīmā
السوء بجهالة	as-sū`a bijahālah
وليست التوبة	wa laisatit-taubah
أحدهم الموت	aḥadahumul-maut
أولئك أعتدنا	ulā`ika a’tadnā
أن ترثوا النساء	an tariṡun-nisā`
بفاحشة مبينة	bifāḥisyatim mubayyinah
وعاشروهن بالمعروف	wa ‘āsyirụhunna bil-ma’rụf
فإن كرهتموهن	fa ing karihtumụhunn
وإن أردتم استبدال	wa in arattumustibdāl
أتأخذونه بهتانا	a ta`khużụnahụ buhtānā
ميثاقا غليظا	mīṡāqan galīẓā
ما نكح آباؤكم	mā nakaḥa ābā`ukum
فاحشة ومقتا	fāḥisyataw wa maqtā
وساء سبيلا	wa sā`a sabīlā
وربائبكم اللاتي	wa raba`ibukumullātī
والمحصنات من النساء	wal-muḥṣanātu minan-nisā`
كتاب الله عليكم	kitāballāhi ‘alaikum
غير مسافحين	gaira musāfiḥīn
فما استمتعتم	fa mastamta’tum
فيما تراضيتم	fīmā tarāḍaitum
من فتياتكم المؤمنات	min fatayātikumul-mu`mināt
أعلم بإيمانكم	a’lamu bi`īmānikum
بعضكم من بعض	ba’ḍukum mim ba’ḍ
متخذات أخدان	muttakhiżāti akhdān
فإذا أحصن	fa iżā uḥṣinn
خشي العنت منكم	khasyiyal-‘anata mingkum
وأن تصبروا	wa an taṣbirụ
ويهديكم سنن الذين	wa yahdiyakum sunanallażīn
أن يتوب عليكم	ay yatụba ‘alaikum
يتبعون الشهوات	yattabi’ụnasy-syahawāt
وخلق الإنسان ضعيفا	wa khuliqal-insānu ḍa’īfā
بينكم بالباطل	bainakum bil-bāṭil
تقتلوا أنفسكم	taqtulū anfusakum
عدوانا وظلما	‘udwānaw wa ẓulmā
تجتنبوا كبائر	tajtanibụ kabā`ir
فضل الله به	faḍḍalallāhu bih
مما اكتسبوا	mimmaktasabụ
مما اكتسبن	mimmaktasabn
واسألوا الله	was`alullāh
ترك الوالدان	tarakal-wālidān
والذين عقدت	wallażīna ‘aqadat
شيء شهيدا	syai`in syahīdā
وبما أنفقوا	wa bimā anfaqụ
فالصالحات قانتات	faṣ-ṣāliḥātu qānitāt
واللاتي تخافون	wallātī takhāfụn
عليهن سبيلا	‘alaihinna sabīlā
عليا كبيرا	‘aliyyang kabīrā
شقاق بينهما	syiqāqa bainihimā
يوفق الله بينهما	yuwaffiqillāhu bainahumā
والجار الجنب	wal-jāril-junub
مختالا فخورا	mukhtālan fakhụrā
ويأمرون الناس	wa ya`murụnan-nās
عذابا مهينا	‘ażābam muhīnā
رئاء الناس	ri`ā`an-nās
قرينا فساء قرينا	qarīnan fa sā`a qarīnā
رزقهم الله	razaqahumullāh
مثقال ذرة	miṡqāla żarrah
يضاعفها ويؤت من لدنه	yuḍā’if-hā wa yu`ti mil ladun-h
هؤلاء شهيدا	hā`ulā`i syahīdā
لو تسوى بهم الأرض	lau tusawwā bihimul-arḍ
الله حديثا	allāha ḥadīṡā
عابري سبيل حتى	‘ābirī sabīlin ḥattā
صعيدا طيبا	ṣa’īdan ṭayyibā
يشترون الضلالة	yasytarụnaḍ-ḍalālah
أعلم بأعدائكم	a’lamu bi`a’dā`ikum
وليا وكفى	waliyyaw wa kafā
بألسنتهم وطعنا	bi`alsinatihim wa ṭa’nā
واسمع وانظرنا	wasma’ wanẓurnā
أصحاب السبت	aṣ-ḥābas-sabt
أمر الله مفعولا	amrullāhi maf’ụlā
أن يشرك به	ay yusyraka bih
فقد افترى	fa qadiftarā
يزكون أنفسهم	yuzakkụna anfusahum
يظلمون فتيلا	yuẓlamụna fatīlā
إثما مبينا	iṡmam mubīnā
بالجبت والطاغوت	bil-jibti waṭ-ṭāgụt
فلن تجد له	fa lan tajida lah
يؤتون الناس نقيرا	yu`tụnan-nāsa naqīrā
يحسدون الناس	yaḥsudụnan-nās
ملكا عظيما	mulkan ‘aẓīmā
من صد عنه	man ṣadda ‘an-h
بجهنم سعيرا	bijahannama sa’īrā
نصليهم نارا	nuṣlīhim nārā
ليذوقوا العذاب	liyażụqul-‘ażāb
ظلا ظليلا	ẓillān ẓalīlā
تؤدوا الأمانات	tu`addul-amānāt
نعما يعظكم	ni’immā ya’iẓukum
وأولي الأمر منكم	wa ulil-amri mingkum
وأحسن تأويلا	wa aḥsanu ta`wīlā
أن يتحاكموا	ay yataḥākamū
ضلالا بعيدا	ḍalālam ba’īdā
رأيت المنافقين	ra`aital-munāfiqīn
إحسانا وتوفيقا	iḥsānaw wa taufīqā
قولا بليغا	qaulam balīgā
ليطاع بإذن الله	liyuṭā’a bi`iżnillāh
لهم الرسول	lahumur-rasụl
قضيت ويسلموا	qaḍaita wa yusallimụ
أن اقتلوا	aniqtulū
وأشد تثبيتا	wa asyadda taṡbītā
وإذا لآتيناهم	wa iżal la`ātaināhum
صراطا مستقيما	ṣirāṭam mustaqīmā
والشهداء والصالحين	wasy-syuhadā`i waṣ-ṣāliḥīn
أولئك رفيقا	ulā`ika rafīqā
ذلك الفضل	żālikal-faḍl
ثبات أو انفروا	ṡubātin awinfirụ
لمن ليبطئن	lamal layubaṭṭi`ann
أكن معهم	akum ma’ahum 
مودة يا ليتني	mawaddatuy yā laitanī
يشرون الحياة 	yasyrụnal-ḥayāh
فسوف نؤتيه	fa saufa nu`tīh
هذه القرية الظالم	hāżihil-qaryah
من لدنك وليا	mil ladungka waliyyā
من لدنك نصيرا	mil ladungka naṣīrā
آمنوا يقاتلون	āmanụ yuqātilụn
سبيل الطاغوت	sabīliṭ-ṭāgụt
كيد الشيطان	kaidasy-syaiṭān
وآتوا الزكاة	wa ātuz-zakāh
يخشون الناس	yakhsyaunan-nās
علينا القتال	‘alainal-qitāl
متاع الدنيا	matā’ud-dun-yā
لمن اتقى	limanittaqā
تظلمون فتيلا	tuẓlamụna fatīlā
يدرككم الموت	yudrikkumul-maut
حسنة يقولوا	ḥasanatuy yaqụlụ
سيئة يقولوا	sayyi`atuy yaqụlụ
كل من	kullum min
هؤلاء القوم	hā`ulā`il-qaum
فمن نفسك	fa min nafsik
للناس رسولا	lin-nāsi rasụlā
من يطع الرسول	may yuṭi’ir-rasụl
عليهم حفيظا	‘alaihim ḥafīẓā
بيت طائفة منهم	bayyata ṭā`ifatum min-hum
يكتب ما يبيتون	yaktubu mā yubayyitụn
فأعرض عنهم	fa a’riḍ ‘an-hum
يتدبرون القرآن	yatadabbarụnal-qur`ān
فيه اختلافا كثيرا	fīhikhtilāfang kaṡīrā
من الأمن أو الخوف	minal-amni awil-khauf
يستنبطونه	yastambiṭụnah
لاتبعتم الشيطان	lattaba’tumusy-syaiṭān
وحرض المؤمنين	wa ḥarriḍil-mu`minīn
بأس الذين	ba`sallażīn
بأسا وأشد تنكيلا	ba`saw wa asyaddu tangkīlā
حسنة يكن له	ḥasanatay yakul lah
يشفع شفاعة سيئة	yasyfa’ syafā’atan sayyi`ah
شيء مقيتا	syai`im muqītā
بتحية فحيوا	bitaḥiyyatin fa ḥayyụ
شيء حسيبا	syai`in ḥasībā
ليجمعنكم	layajma’annakum
ومن أصدق	wa man aṣdaq
في المنافقين	fil-munāfiqīn
أن تهدوا	an tahdụ
فلا تتخذوا	fa lā tattakhiżụ
وجدتموهم	wajattumụhum
ميثاق أو جاءوكم	mīṡāqun au jā`ụkum
لسلطهم عليكم	lasallaṭahum ‘alaikum
إليكم السلم	ilaikumus-salam
ويأمنوا قومهم	wa ya`manụ qaumahum
الفتنة أركسوا	al-fitnati urkisụ
سلطانا مبينا	sulṭānam mubīnā
إلا خطأ	illā khaṭa`ā
ودية مسلمة	wa diyatum musallamah
فتحرير رقبة	fa taḥrīru raqabah
رقبة مؤمنة	raqabatim mu`minah
متتابعين توبة	mutatābi’aini taubah
ألقى إليكم السلام	alqā ilaikumus-salām
مغانم كثيرة	magānimu kaṡīrah
فتبينوا	fa tabayyanụ
أولي الضرر	uliḍ-ḍarar
القاعدين درجة	al-qā’idīna darajah
وعد الله الحسنى	wa’adallāhul-ḥusnā
أجرا عظيما	ajran ‘aẓīmā
درجات منه	darajātim min-h
توفاهم الملائكة	tawaffāhumul-malā`ikah
كنا مستضعفين	kunnā mustaḍ’afīn
فتهاجروا فيها	fa tuhājirụ fīhā
مأواهم جهنم	ma`wāhum jahannam
وساءت مصيرا	wa sā`at maṣīrā
حيلة ولا	ḥīlataw wa lā
أن يعفو عنهم	ay ya’fuwa ‘an-hum
مراغما كثيرا وسعة	murāgamang kaṡīraw wa sa’ah
يدركه الموت	yudrik-hul-maut
أن تقصروا	an taqṣurụ
عدوا مبينا	‘aduwwam mubīnā
وليأخذوا أسلحتهم	walya`khużū asliḥatahum
طائفة أخرى	ṭā`ifatun ukhrā
ميلة واحدة	mailataw wāḥidah
من مطر أو كنتم	mim maṭarin au kuntum
وخذوا حذركم	wa khużụ ḥiżrakum
أعد للكافرين	a’adda lil-kāfirīn
قضيتم الصلاة	qaḍaitumuṣ-ṣalāh
فإذا اطمأننتم	fa iżaṭma`nantum
كانت على	kānat ‘alā
في ابتغاء القوم	fibtigā`il-qaụm
يألمون كما تألمون	ya`lamụna kamā ta`lamụn
أراك الله	arākallāh
للخائنين خصيما	lil-khā`inīna khaṣīmā
واستغفر الله	wastagfirillāh
يختانون أنفسهم	yakhtānụna anfusahum
خوانا أثيما	khawwānan aṡīmā
إذ يبيتون	iż yubayyitụn
يعملون محيطا	ya’malụna muḥīṭā
هؤلاء جادلتم	hā`ulā`i jādaltum
من يكون عليهم	may yakụnu ‘alaihim
سوءا أو يظلم	sū`an au yaẓlim
إثما فإنما	iṡman fa innamā
بهتانا وإثما	buhtānaw wa iṡmā
طائفة منهم	ṭā`ifatum min-hum
يضرونك	yaḍurrụnak
تكن تعلم	takun ta’lam
إصلاح بين	iṣlāḥim bain
ذلك ابتغاء	żālikabtigā`
نوله ما تولى	nuwallihī mā tawallā
ضل ضلالا	ḍalla ḍalālā
إلا إناثا	illā ināṡā
شيطانا مريدا	syaiṭānam marīdā
لعنه الله	la’anahullāh
نصيبا مفروضا	naṣībam mafrụḍā
ولآمرنهم فليغيرن	wa la`āmurannahum fa layugayyirunn
خسر خسرانا	khasira khusrānā
يعدهم ويمنيهم	ya’iduhum wa yumannīhim
يعدهم الشيطان	ya’iduhumusy-syaiṭān
عنها محيصا	‘an-hā mahīṣā
سندخلهم	sanudkhiluhum
وعد الله حقا	wa’dallāhi ḥaqqā
ليس بأمانيكم	laisa bi`amāniyyikum
سوءا يجز به	sū`ay yujza bih
يظلمون نقيرا	yuẓlamụna naqīrā
دينا ممن	dīnam mim man
إبراهيم خليلا	ibrāhīma khalīlā
ويستفتونك في النساء	wa yastaftụnaka fin-nisā`
يتامى النساء اللاتي	yatāman-nisā`illātī
وإن امرأة خافت	wa inimra`atun khāfat
والصلح خير	waṣ-ṣul-ḥu khaīr
وأحضرت الأنفس الشح	uḥḍiratil-anfususy-syuḥḥ
تحسنوا وتتقوا	tuḥsinụ wa tattaqụ
كل الميل	kullal-mail
فتذروها كالمعلقة	fa tażarụhā kal-mu’allaqah
تصلحوا وتتقوا	tuṣliḥụ wa tattaqụ
كلا من سعته	kullam min sa’atih
واسعا حكيما	wāsi’an ḥakīmā
وصينا الذين	waṣṣainallażīn
غنيا حميدا	ganiyyan ḥamīdā
إن يشأ يذهبكم	iy yasya` yuż-hibkum
ذلك قديرا	żālika qadīrā
ثواب الدنيا	ṡawābud-dun-yā
سميعا بصيرا	samī’am baṣīrā
أو الوالدين والأقربين	awil-wālidaini wal-aqrabīn
فقيرا فالله	faqīran fallāh
تتبعوا الهوى	tattabi’ul-hawā
تلووا أو تعرضوا	talwū au tu’riḍụ
والكتاب الذي	wal-kitābillāżī
ثم ازدادوا	ṡummazdādụ
بشر المنافقين	basysyiril-munāfiqīn
دون المؤمنين	dụnil-mu`minīn
عندهم العزة	‘indahumul-‘izzah
ويستهزأ بها	wa yustahza`u bihā
جهنم جميعا	jahannama jamī’ā
يتربصون بكم	yatarabbaṣụna bikum
نستحوذ عليكم	nastaḥwiż ‘alaikum
يحكم بينكم	yaḥkumu bainakum
المؤمنين سبيلا	al-mu`minīna sabīlā
وهو خادعهم	wa huwa khādi’ụhum
قاموا كسالى	qāmụ kusālā
مذبذبين بين	mużabżabīna bain
له سبيلا	lahụ sabīlā
تتخذوا الكافرين	tattakhiżul-kāfirīn
في الدرك	fid-dark
وأخلصوا دينهم	wa akhlaṣụ dīnahum
وسوف يؤت	wa saufa yu`t
وآمنتم	wa āmantum
الجهر بالسوء	al-jahra bis-sū`
عفوا قديرا	‘afuwwang qadīrā
ببعض ونكفر	biba’ḍiw wa nakfur
الكافرون حقا	al-kāfirụna ḥaqqā
يؤتيهم أجورهم	yu`tīhim ujụrahum
فأخذتهم الصاعقة	fa akhażat-humuṣ-ṣā’iqah
فعفونا عن ذلك	fa ‘afaunā ‘an żālik
لا تعدوا	lā ta’dụ
وقتلهم الأنبياء	wa qatlihimul-ambiyā`
طبع الله	ṭaba’allāh
بهتانا عظيما	buhtānan ‘aẓīmā
قتلنا المسيح	qatalnal-masīḥ
شبه لهم	syubbiha lahum
الذين اختلفوا	allażīnakhtalafụ
إلا اتباع الظن	illāttibā’aẓ-ẓann
بل رفعه الله	bal rafa’ahullāh
قبل موته	qabla mautih
طيبات أحلت	ṭayyibātin uḥillāt
وأخذهم الربا	wa akhżihimur-ribā
لكن الراسخون	lākinir-rāsikhụn
أولئك سنؤتيهم	ulā`ika sanu`tīhim
نوح والنبيين	nụḥiw wan-nabiyyīn
وهارون وسليمان	wa hārụna wa sulaimān
داوود زبورا	dāwụda zabụrā
ورسلا قد	wa rusulang qad
موسى تكليما	mụsā taklīmā
حجة بعد الرسل	ḥujjatum ba’dar-rusul
أنزله بعلمه	anzalahụ bi’ilmih
والملائكة يشهدون	wal-malā`ikatu yasy-hadụn
ليهديهم طريقا	liyahdiyahum ṭarīqā
طريق جهنم	ṭarīqa jahannam
فآمنوا خيرا لكم	fa āminụ khairal lakum
لا تغلوا	lā taglụ
إنما المسيح	innamal-masīḥ
وروح منه	wa rụḥum min-h
تقولوا ثلاثة	taqụlụ ṡalāṡah
انتهوا خيرا	intahụ khairā
إله واحد	ilāhuw wāḥid
سبحانه أن	sub-ḥānahū an
لن يستنكف المسيح	lay yastangkifal-masīḥ
ومن يستنكف عن	wa may yastangkif ‘an
فيوفيهم أجورهم	fa yuwaffīhim ujụrahum
الذين استنكفوا	allażīnastangkafụ
نورا مبينا	nụram mubīnā
فسيدخلهم	fa sayudkhiluhum
يستفتونك	yastaftụnak
في الكلالة	fil-kalālah
نصف ما ترك	niṣfu mā tarak
يكن لها ولد	yakul lahā walad
فإن كانتا اثنتين	fa ing kānataṡnatain
إخوة رجالا	ikhwatar rijālā
أن تضلوا	an taḍillụ
أوفوا بالعقود	aufụ bil-‘uqụd
بهيمة الأنعام	bahīmatul-an’ām
تحلوا شعائر	tuḥillụ sya’ā`ir
حللتم فاصطادوا	ḥalaltum faṣṭādụ
شنآن قوم	syana`ānu qaum
البر والتقوى	al-birri wat-taqwā
والمنخنقة والموقوذة	ḥwal-munkhaniqatu wal-mauqụżah
تستقسموا بالأزلام	tastaqsimụ bil-azlām
ذلكم فسق	żālikum fisq
تخشوهم واخشون	takhsyauhum wakhsyaụn
نعمتي ورضيت	ni’matī wa raḍīt
متجانف لإثم	mutajānifil li`iṡm
أحل لهم	uḥillā lahum
الجوارح مكلبين	al-jawāriḥi mukallibīn
اليوم أحل	al-yauma uḥill
إذا آتيتموهن	iżā ātaitumụhunn
حبط عمله	ḥabiṭa ‘amaluh
وامسحوا برءوسكم	wamsaḥụ biru`ụsikum
جنبا فاطهروا	junuban faṭṭahharụ
صعيدا طيبا	ṣa’īdan ṭayyibā
ليطهركم وليتم	liyuṭahhirakum wa liyutimm
واثقكم به	wāṡaqakum bih
بذات الصدور	biżātiṣ-ṣudụr
شهداء بالقسط	syuhadā`a bil-qisṭ
اعدلوا هو	i’dilụ hụ
وأجر عظيم	wa ajrun ‘aẓīm
وكذبوا بآياتنا	wa każżabụ bi`āyātinā
آمنوا اذكروا	āmanużkurụ
منهم اثني	min-humuṡnai
وآمنتم برسلي	wa āmantum birusulī
قلوبهم قاسية 	qulụbahum qāsiyah
حظا مما	ḥaẓẓam mimmā
خائنة منهم	khā`inatim min-hum
بينهم العداوة	bainahumul-‘adāwah
ينبئهم الله	 yunabbi`uhumullāh
عن كثير	‘ang kaṡīr
نور وكتاب مبين	nụruw wa kitābum mubīn
من اتبع رضوانه	manittaba’a riḍwānah
لقد كفر	laqad kafar
يهلك المسيح	yuhlikal-masīḥamī’ā
يخلق ما يشاء	yakhluqu mā yasyā`
وأحباؤه	wa aḥibbā`uh
فلم يعذبكم	fa lima yu’ażżibukum
بشر ممن خلق	basyarum mim man khalaq
وإليه المصير	wa ilaihil-maṣīr
فترة من الرسل	fatratim minar-rusul
بشير ونذير	basyīruw wa nażīr
ملوكا وآتاكم	mulụkaw wa ātākum
المقدسة التي	al-muqaddasatallatī
قوما جبارين	qauman jabbārīn
فإنا داخلون	fa innā dākhilụn
عليهما ادخلوا	‘alaihimadkhulụ
فإذا دخلتموه	fa iżā dakhaltumụh
هاهنا قاعدون	hāhunā qā’idụn
فافرق بيننا	fafruq bainanā
أربعين سنة	arba’īna sanah
يتيهون في الأرض	yatīhụna fil-arḍ
فلا تأس	fa lā ta`s
نبأ ابني	naba`abnai
قربا قربانا	qarrabā qurbānā
قال لأقتلنك	qāla la`aqtulannak
من المتقين	minal-muttaqīn
بباسط يدي 	bibāsiṭiy yadiy
أخاف الله	akhāfullāh
تبوء بإثمي وإثمك	tabū`a bi`iṡmī wa iṡmik
جزاء الظالمين	jazā`uẓ-ẓālimīn
أخيه فقتله	akhīhi fa qatalah
غرابا يبحث	gurābay yab-ḥaṡ
فأواري سوءة	fa uwāriya sau`ah
فأصبح من النادمين	fa aṣbaḥa minan-nādimīn
فكأنما قتل	fa ka`annamā qatal
أحياها فكأنما	aḥyāhā fa ka`annamā
رسلنا بالبينات	rusulunā bil-bayyināt
يصلبوا أو تقطع	yuṣallabū au tuqaṭṭa’
إلا الذين تابوا	illāllażīna tābụ
فاعلموا أن	fa’lamū an
إليه الوسيلة	ilaihil-wasīlah
معه ليفتدوا	ma’ahụ liyaftadụ
هم بخارجين	hum bikhārijīn
والسارق والسارقة	was-sāriqu was-sāriqah
ظلمه وأصلح	ẓulmihī wa aṣlaḥ
يشاء ويغفر	yasyā`u wa yagfir
تؤمن قلوبهم	tu`ming qulụbuhum
للكذب سماعون	lil-każibi sammā’ụn
يحرفون الكلم	yuḥarrifụnal-kalim
هذا فخذوه	hāżā fa khużụh
فتنته فلن تملك	fitnatahụ fa lan tamlik
يطهر قلوبهم	yuṭahhira qulụbahum
الآخرة عذاب	al-ākhirati ‘ażāb
أكالون للسحت	akkālụna lis-suḥt
فاحكم بينهم	faḥkum bainahum
يضروك شيئا	yaḍurrụka syai`ā
بينهم بالقسط	bainahum bil-qisṭ
يحب المقسطين	yuḥibbul-muqsiṭīn
وعندهم التوراة	wa ‘indahumut-taurāh
هدى ونور	hudaw wa nụr
بما استحفظوا	bimastuḥfiẓụ
بآياتي ثمنا	bi`āyātī ṡamanā
ومن لم يحكم	wa mal lam yaḥkum
والأنف بالأنف	wal-anfa bil-anf
كفارة له	kaffāratul lah
أنزل الله	anzalallāh
آثارهم بعيسى	āṡārihim bi’īsā
وليحكم أهل الإنجيل	walyaḥkum ahlul-injīl
لم يحكم بما	lam yaḥkum bimā
عما جاءك	 ‘ammā jā`ak
شرعة ومنهاجا	syir’ataw wa min-hājā
آتاكم فاستبقوا	ātākum fastabiqụ
فيه تختلفون	fīhi takhtalifụn
تتبع أهواءهم	tattabi’ ahwā`ahum
ببعض ذنوبهم	biba’ḍi żunụbihim
الناس لفاسقون	an-nāsi lafāsiqụn
حكما لقوم	ḥukmal liqaum
والنصارى أولياء	wan-naṣārā auliyā`
أولياء بعض	auliyā`u ba’ḍ
ومن يتولهم	wa may yatawallahum
يهدي القوم	yahdil-qaum
تصيبنا دائرة	tuṣībanā dā`irah
يأتي بالفتح	ya`tiya bil-fat-ḥ
جهد أيمانهم	jahda aimānihim
فأصبحوا خاسرين	fa aṣbaḥụ khāsirīn
ويحبونه أذلة	wa yuḥibbụnahū ażillāh
يقيمون الصلاة	yuqīmụnaṣ-ṣalāh
حزب الله	ḥizballāh
هزوا ولعبا	huzuwaw wa la’ibā
كنتم مؤمنين	kuntum mu`minīn
الصلاة اتخذوها	aṣ-ṣalātittakhażụhā
قوم لا يعقلون	qaumul lā ya’qilụn
أكثركم فاسقون	akṡarakum fāsiqụn
أنبئكم بشر	unabbi`ukum bisyarr
وعبد الطاغوت	wa ‘abadaṭ-ṭāgụt
شر مكانا وأضل	syarrum makānaw wa aḍall
خرجوا به	kharajụ bih
يكتمون	yaktumụn
وأكلهم السحت	wa aklihimus-suḥt
ينهاهم الربانيون	yan-hāhumur-rabbāniyyụn
يصنعون	yaṣna’ụn
مغلولة	maglụlah
مبسوطتان ينفق	mabsụṭatāni yunfiq
طغيانا وكفرا	ṭugyānaw wa kufrā
العداوة والبغضاء	al-‘adāwata wal-bagḍā`
نارا للحرب	nāral lil-ḥarb
جنات النعيم	jannātin-na’īm
تحت أرجلهم	taḥti arjulihim
أمة مقتصدة	ummatum muqtaṣidah
وكثير منهم	wa kaṡīrum min-hum
بلغ ما	ballig mā
بلغت رسالته	ballagta risālatah
يعصمك من	ya’ṣimuka min
تقيموا التوراة	tuqīmut-taurāh
طغيانا وكفرا	ṭugyānaw wa kufrā
والصابئون والنصارى	waṣ-ṣābi`ụna wan-naṣārā
إليهم رسلا	ilaihim rusulā
فريقا كذبوا	farīqang każżabụ
عموا وصموا	‘amụ wa ṣammụ
إسرائيل اعبدوا	isrā`īla’budụ
ومأواه النار	wa ma`wāhun-nār
للظالمين	liẓ-ẓālimīn
ثالث ثلاثة	ṡāliṡu ṡalāṡah
إله واحد	ilāhuw wāḥid
ليمسن الذين	layamassannallażīn
ويستغفرونه	wa yastagfirụnah
ما المسيح	mal-masīḥ
قبله الرسل	qablihir-rusul
وأمه صديقة	wa ummuhụ ṣiddīqah
يأكلان الطعام 	ya`kulāniṭ-ṭa’ām
ثم انظر	ṡummanẓur
ضرا ولا نفعا	ḍarraw wa lā naf’ā
تتبعوا أهواء	tattabi’ū ahwā`
لسان داوود	lisāni dāwụd
منكر فعلوه	mungkarin fa’alụh
ترى كثيرا	tarā kaṡīrā
سخط الله	sakhiṭallāh
ما اتخذوهم	mattakhażụhum
عداوة للذين	‘adāwatal lillāżīn
مودة للذين	mawaddatal lillāżīn
قسيسين ورهبانا	qissīsīna wa ruhbānā
أعينهم تفيض	a’yunahum tafīḍ
مع الشاهدين	ma’asy-syāhidīn
مع القوم الصالحين	ma’al-qaumiṣ-ṣāliḥīn
فأثابهم الله	fa aṡābahumullāh
جزاء المحسنين	jazā`ul-muḥsinīn
بآياتنا أولئك	bi`āyātinā ulā`ik
لا تحرموا طيبات	lā tuḥarrimụ ṭayyibāt
يحب المعتدين	yuḥibbul-mu’tadīn
حلالا طيبا	ḥalālan ṭayyibā
باللغو في	bil-lagwi fī
عشرة مساكين	‘asyarati masākīn
ثلاثة أيام	ṡalāṡati ayyām
إذا حلفتم	iżā ḥalaftum
واحفظوا أيمانكم	waḥfaẓū aimānakum
آياته لعلكم	āyātihī la’allakum
والأنصاب والأزلام	wal-anṣābu wal-azlām
أنتم منتهون	antum muntahụn
واحذروا	waḥżarụ
البلاغ المبين	al-balāgul-mubīn
ثم اتقوا وأحسنوا	ṡummattaqaw wa aḥsanụ
يحب المحسنين	yuḥibbul-muḥsinīn
ورماحكم ليعلم	wa rimāḥukum liya’lam
فمن اعتدى	fa mani’tadā
تقتلوا الصيد	taqtuluṣ-ṣaid
متعمدا فجزاء	muta’ammidan fa jazā`
عما سلف	‘ammā salaf
عاد فينتقم	‘āda fa yantaqim
ذو انتقام	żuntiqām
وطعامه متاعا	wa ṭa’āmuhụ matā’ā
صيد البر ما دمتم	ṣaidul-barri mā dumtum
إليه تحشرون	ilaihi tuḥsyarụn
والقلائد	wal-qalā`id
إلا البلاغ	illāl-balāg
ما تبدون	mā tubdụnā
كثرة الخبيث	kaṡratul khabīṡ
أولي الألباب	ulil-albāb
تسؤكم	tasu`kum
تبد لكم	tubda lakum
ثم أصبحوا	ṡumma aṣbaḥụ
بحيرة ولا سائبة	baḥīratiw wa lā sā`ibah
عليه آباءنا	‘alaihi ābā`anā
ولا يهتدون	wa lā yahtadụn
عليكم أنفسكم	‘alaikum anfusakum
إذا اهتديتم	iżahtadaitum
جميعا فينبئكم	jamī’an fa yunabbi`ukum
شهادة بينكم	syahādatu bainikum
لمن الآثمين	laminal-āṡimīn
أنهما استحقا	annahumastaḥaqqā
وجهها أو يخافوا	waj-hihā au yakhāfū
واتقوا الله واسمعوا	wattaqullāha wasma’ụ
ماذا أجبتم	māżā ujibtum
علام الغيوب	‘allāmul-guyụb
على والدتك	‘alā wālidatik
إذ أيدتك	iż ayyattuk
المهد وكهلا	al-mahdi wa kahlā
علمتك الكتاب	‘allamtukal-kitāb
وتبرئ الأكمه	wa tubri`ul-akmah
الموتى بإذني	al-mautā bi`iżnī
وإذ كففت	wa iż kafaft
أن آمنوا	an āminụ
آمنا واشهد	āmannā wasy-had
يستطيع ربك	yastaṭī’u rabbuk
وتطمئن قلوبنا	wa taṭma`inna qulụbunā
علينا مائدة	‘alainā mā`idah
منزلها عليكم	munazziluhā ‘alaikum
أعذبه أحدا	u’ażżibuhū aḥadā
وأمي إلهين	wa ummiya ilāhain
ليس لي بحق	laisa lī biḥaqq
فقد علمته	fa qad ‘alimtah
في نفسك	fī nafsik
ما أمرتني	mā amartanī
ما دمت فيهم	mā dumtu fīhim
أنت الرقيب	antar-raqīb
شيء شهيد	syai`in syahīd
فإنهم عبادك	fa innahum ‘ibāduk
وإن تغفر	wa in tagfir
ينفع الصادقين	yanfa’uṣ-ṣādiqīn
ورضوا عنه	wa raḍụ ‘an-h
وما فيهن	wa mā fīhinn
وجعل الظلمات	wa ja’alaẓ-ẓulumāt
بربهم يعدلون	birabbihim ya’dilụn
قضى أجلا	qaḍā ajalā
أنتم تمترون	antum tamtarụn
سركم وجهركم	sirrakum wa jahrakum
آية من آيات	āyatim min āyāt
كذبوا بالحق	każżabụ bil-ḥaqq
به يستهزئون	bihī yastahzi`ụn
مدرارا	midrārā
قرطاس فلمسوه	qirṭāsin fa lamasụh
لولا أنزل	lau lā unzil
ملكا لقضي	malakal laquḍī
رجلا وللبسنا 	rajulaw wa lalabasnā
ولقد استهزئ	wa laqadistuhzi`
عاقبة المكذبين	‘āqibatul-mukażżibīn
لمن ما	qul limam mā fis-samāwāti wal-arḍ
قل لله	qul lillāh
نفسه الرحمة	kataba ‘alā nafsihir-raḥmah
ريب فيه	raiba fīh
خسروا أنفسهم	khasirū anfusahum
الليل والنهار	al-laili wan-nahār
أتخذ وليا فاطر	attakhiżu waliyyan fāṭir
أمرت أن أكون	umirtu an akụn
أخاف إن عصيت	akhāfu in ‘aṣait
من يصرف عنه	may yuṣraf ‘an-h
الفوز المبين	al-fauzul-mubīn
بضر فلا كاشف	biḍurrin fa lā kāsyif
وإن يمسسك	wa iy yamsask
فوق عباده	fauqa ‘ibādih
أكبر شهادة	akbaru syahādah
قل الله	qulillāh
شهيد بيني	syahīdum bainī
القرآن لأنذركم	al-qur`ānu li`unżirakum
آلهة أخرى	ālihatan ukhrā
قل لا أشهد	qul lā asy-had
وإنني بريء	wa innanī barī`
يعرفون أبناءهم	ya’rifụna abnā`ahum
خسروا أنفسهم	khasirū anfusahum
ممن افترى	mim maniftarā
يفلح الظالمون	yufliḥuẓ-ẓālimụn
أشركوا أين شركاؤكم	asyrakū aina syurakā`ukum
تكن فتنتهم	takun fitnatuhum
كيف كذبوا	kaifa każabụ
يستمع إليك	yastami’u ilaīk
آذانهم وقرا	āżānihim waqrā
يروا كل آية لا	yarau kulla āyatil lā
جاءوك يجادلونك	jā`ụka yujādilụnak
وينأون عنه	wa yan`auna ‘an-h
وإن يهلكون	wa iy yuhlikụn
ليتنا نرد	laitanā nurad
بل بدا لهم	bal badā lahum
ردوا لعادوا	ruddụ la’ādụ
نحن بمبعوثين	naḥnu bimab’ụṡīn
ترى إذ وقفوا	tarā iż wuqifụ
قال أليس	qāla a laisa
بلى وربنا	balā wa rabbinā
كذبوا بلقاء الله	każżabụ biliqā`illāh
جاءتهم الساعة بغتة	jā`at-humus-sā’atu bagtah
ألا ساء ما يزرون	alā sā`a mā yazirụn
لعب ولهو	la’ibuw wa lahw
وللدار الآخرة	wa lad-dārul-ākhirah
بآيات الله يجحدون	bi`āyātillāhi yaj-ḥadụn
كذبوا وأوذوا	kużżibụ wa ụżụ
مبدل لكلمات الله	mubaddila likalimātillāh
من نبإ المرسلين	min naba`il-mursalīn
فتأتيهم بآية	fa ta`tiyahum bi`āyah
من الجاهلين	minal-jāhilīn
إنما يستجيب	innamā yastajīb
والموتى يبعثهم	wal-mautā yab’aṡuhum
لولا نزل	lau lā nuzzil
آية ولكن	āyataw wa lākin
طائر يطير	ṭā`iriy yaṭīr
ربهم يحشرون	rabbihim yuḥsyarụn
بآياتنا صم	bi`āyātinā ṣumm
من يشإ الله	may yasya`illāh
من يشأ يجعله	may yasya` yaj’al-h
أتتكم الساعة	atatkumus-sā’ah
إن كنتم صادقين	ing kuntum ṣādiqīn
تدعون فيكشف	tad’ụna fa yaksyif
بالبأساء والضراء	bil-ba`sā`i waḍ-ḍarrā`
بأسنا تضرعوا	ba`sunā taḍarra’ụ
فلما نسوا	fa lammā nasụ
أوتوا أخذناهم	ụtū akhażnāhum
فقطع دابر	fa quṭi’a dābir
أرأيتم	a ra`aitum
نصرف الآيات	nuṣarriful-āyāt
أرأيتكم إن أتاكم	a ra`aitakum in atākum
مبشرين ومنذرين	mubasysyirīna wa munżirīn
آمن وأصلح	āmana wa aṣlaḥ
بآياتنا يمسهم	bi`āyātinā yamassuhum
عندي خزائن	‘indī khazā`in
يستوي الأعمى	yastawil-a’mā
أفلا تتفكرون	a fa lā tatafakkarụn
شفيع لعلهم	syafī’ul la’allahum
بالغداة والعشي	bil-gadāti wal-‘asyī
فتطردهم فتكون	fa taṭrudahum fa takụn
ليقولوا أهؤلاء	liyaqụlū a hā`ulā`
بأعلم بالشاكرين	bi`a’lama bisy-syākirīn
بجهالة ثم تاب	 bijahālatin ṡumma tāb
نفصل الآيات	nufaṣṣilul-āyāt
نهيت أن	nuhītu an
قد ضللت	qad ḍalalt
بينة من ربي	bayyinatim mir rabbī
تستعجلون به	tasta’jilụna bih
إن الحكم	inil-ḥukm
يقص الحق	yaquṣṣul-ḥaqq
لو أن عندي	lau anna ‘indī
أعلم بالظالمين	a’lamu biẓ-ẓālimīn
مفاتح الغيب	mafātiḥul-gaib
تسقط من ورقة	tasquṭu miw waraqah
يتوفاكم بالليل	yatawaffākum bil-lail
ينبئكم	yunabbi`ukum
القاهر فوق	al-qāhiru fauq
توفته رسلنا	tawaffat-hu rusulunā
مولاهم الحق	maulāhumul-ḥaqq
أسرع الحاسبين	asra’ul-ḥāsibīn
تضرعا وخفية	taḍarru’aw wa khufyah
لئن أنجانا	la`in anjānā
كل كرب	kulli karb
شيعا ويذيق	syiya’aw wa yużīq
انظر كيف	unẓur kaif
قومك	qaumuk
بوكيل	biwakīl
نبإ مستقر	naba`im mustaqarr
حديث غيره	ḥadīṡin gairih
ينسينك الشيطان	yunsiyannakasy-syaiṭān
ولكن ذكرى	wa lākin żikrā
لعبا ولهوا	la’ibaw wa lahwā
تعدل كل عدل لا	ta’dil kulla ‘adlil lā
أبسلوا بما كسبوا	ubsilụ bimā kasabụ
كالذي استهوته	kallażistahwat-h
وأمرنا لنسلم	wa umirnā linuslim
الصلاة واتقوه	aṣ-ṣalāta wattaqụh
قوله الحق	qauluhul-ḥaqq
ينفخ في الصور	yunfakhu fiṣ-ṣụr
عالم الغيب	‘ālimul-gaib
آزر أتتخذ	āzara a tattakhiżu
أصناما آلهة	aṣnāman ālihah
أراك وقومك	arāka wa qaumak
نري إبراهيم	nurī ibrāhīm
رأى كوكبا	ra`ā kaukabā
قال هذا ربي	qāla hāżā rabbī
أحب الآفلين	uḥibbul-āfilīn
رأى القمر بازغا	ra`al-qamar
لئن لم يهدني	la`il lam yahdinī
بازغة قال	bāzigatang qāl
فلما أفلت	fa lammā afalat
وجهي للذي	waj-hiya lillażī
وحاجه قومه	wa ḥājjahụ qaumuh
وقد هدان	wa qad hadān
ربي شيئا	rabbī syai`ā
وسع ربي	wasi’a rabbī
أفلا تتذكرون	a fa lā tatażakkarụn
أخاف ما أشركتم	akhāfu mā asyraktum
فأي الفريقين	fa ayyul-farīqain
أحق بالأمن	aḥaqqu bil-amn
يلبسوا إيمانهم	yalbisū īmānahum
حجتنا آتيناها	ḥujjatunā ātaināhā
درجات من	narfa’u darajātim man nasyā`
ووهبنا له	wa wahabnā lah
ذريته داوود	żurriyyatihī dāwụd
نجزي المحسنين	najzil-muḥsinīn
وزكريا ويحيى	wa zakariyyā wa yaḥyā
واليسع ويونس	walyasa’a wa yụnus
وكلا فضلنا	wa kullan faḍḍalnā
آبائهم وذرياتهم	ābā`ihim wa żurriyyātihim
واجتبيناهم وهديناهم	wajtabaināhum wa hadaināhum
يهدي به	yahdī bih
أشركوا لحبط	asyrakụ laḥabiṭ
والحكم والنبوة	wal-ḥukma wan-nubuwwah
قوما ليسوا	qaumal laisụ
فبهداهم اقتده	fa bihudāhumuqtadih
لا أسألكم	lā as`alukum
ذكرى للعالمين	żikrā lil-‘ālamīn
حق قدره	ḥaqqa qadrih
تجعلونه قراطيس	taj’alụnahụ qarāṭīs
وعلمتم ما لم	wa ‘ullimtum mā lam
خوضهم يلعبون	khauḍihim yal’abụn
مبارك مصدق	mubārakum muṣaddiq
صلاتهم يحافظون	ṣalātihim yuḥāfiẓụn
سأنزل مثل	sa`unzilu miṡl
غمرات الموت 	gamarātil-maut
أخرجوا أنفسكم	akhrijū anfusakum
آياته تستكبرون	āyātihī tastakbirụn
جئتمونا فرادى	ji'tumūnā furādā
شفعاءكم الذين	syufa’ā`akumullażīn
لقد تقطع	laqat taqaṭṭa’
فالق الحب	fāliqul-ḥabb
ومخرج الميت	wa mukhrijul-mayyit
فأنى تؤفكون	fa annā tu`fakụn
فالق الإصباح	fāliqul-iṣbāḥ
والقمر حسبانا	wal-qamara ḥusbānā
تقدير العزيز	taqdīrul-‘azīz
النجوم لتهتدوا	an-nujụma litahtadụ
فصلنا الآيات	faṣṣalnal-āyāt
فمستقر ومستودع	fa mustaqarruw wa mustauda’
لقوم يفقهون	liqaumiy yafqahụn
السماء ماء	as-samā`i mā`
حبا متراكبا	ḥabbam mutarākibā
قنوان دانية	qinwānun dāniyah
أثمر وينعه	aṡmara wa yan’ih
لقوم يؤمنون	liqaumiy yu`minụn
بنين وبنات	banīna wa banāt
عما يصفون	‘ammā yaṣifụn
له صاحبة	lahụ ṣāḥibah
تدركه الأبصار	tudrikuhul-abṣār
اللطيف الخبير	al-laṭīful-khabīr
جاءكم بصائر	jā`akum baṣā`ir
أبصر فلنفسه	abṣara fa linafsih
عمي فعليها	‘amiya fa ‘alaihā
وما أنا عليكم	wa mā ana ‘alaikum
درست ولنبينه	darasta wa linubayyinah
اتبع ما أوحي	ittabi’ mā ụḥī
وأعرض عن	a’riḍ ‘an
ما أشركوا	mā asyrakụ
عليهم حفيظا	‘alaihim ḥafīẓā
عليهم بوكيل	‘alaihim biwakīl
فيسبوا الله	fa yasubbullāh
مرجعهم فينبئهم	marji’uhum fa yunabbi`uhum
ليؤمنن بها	layu`minunna bihā
يشعركم أنها	yusy’irukum annahā
أفئدتهم وأبصارهم	af`idatahum wa abṣārahum
أكثرهم يجهلون	akṡarahum yaj-halụn
عدوا شياطين	‘aduwwan syayāṭīn
فعلوه فذرهم	fa’alụhu fa żar-hum
ولتصغى إليه	wa litaṣgā ilaih
الكتاب مفصلا	al-kitāba mufaṣṣalā
أنه منزل	annahụ munazzal
صدقا وعدلا	ṣidqaw wa ‘adlā
لا مبدل لكلماته	lā mubaddila likalimātih
تطع أكثر	tuṭi’ akṡar
يتبعون إلا الظن	yattabi’ụna illaẓ-ẓann
أعلم من يضل	a’lamu may yaḍill
أعلم بالمهتدين	 a’lamu bil-muhtadīn
فكلوا مما	fa kulụ mimmā
ما اضطررتم إليه	maḍṭurirtum ilaīh
ليضلون بأهوائهم	layuḍillụna bi`ahwā`ihim
أعلم بالمعتدين	a’lamu bil-mu’tadīn
وذروا ظاهر	wa żarụ ẓāhir
الإثم وباطنه	al-iṡmi wa bāṭinah
الإثم سيجزون	nal-iṡma sayujzaun
وإنه لفسق	wa innahụ lafisq
الشياطين ليوحون	sy-syayāṭīna layụḥụn
أطعتموهم إنكم	aṭa’tumụhum innakum
ميتا فأحييناه	maitan fa aḥyaināh
زين للكافرين	zuyyina lil-kāfirīn
قرية أكابر	qaryatin akābir
بأنفسهم	bi`anfusihim
نؤتى مثل	nu`tā miṡl
حيث يجعل	ḥaiṡu yaj’al
صغار عند	ṣagārun ‘ind
يشرح صدره	yasyraḥ ṣadrah
صدره ضيقا	ṣadrahụ ḍayyiqā
كذلك يجعل	każālika yaj’al
صراط ربك	ṣirāṭu rabbik
قد فصلنا	qad faṣṣalnā
دار السلام	dārus-salām
يحشرهم جميعا	yaḥsyuruhum jamī’ā
قد استكثرتم	qadistakṡartum
ربنا استمتع	rabbanastamta’
النار مثواكم	an-nāru maṡwākum
ربك حكيم	rabbaka ḥakīm
الظالمين بعضا	aẓ-ẓālimīna ba’ḍā
وينذرونكم لقاء	wa yunżirụnakum liqā`
وغرتهم الحياة	wa garrat-humul-ḥayāh
مهلك القرى	muhlikal-qurā
ولكل درجات	wa likullin darajāt
ربك بغافل	rabbuka bigāfil
وربك الغني	wa rabbukal-ganī
يذهبكم ويستخلف	yuż-hibkum wa yastakhlif
توعدون لآت	tụ’adụna la`āt
قوم اعملوا	qaumi’malụ
عاقبة الدار	‘āqibatud-dār
يفلح الظالمون	yufliḥuẓ-ẓālimụn
والأنعام نصيبا	wal-an’āmi naṣībā
كان لشركائهم	kāna lisyurakā`ihim
فهو يصل	fa huwa yaṣil
ساء ما يحكمون	sā`a mā yaḥkumụn
ليردوهم وليلبسوا	liyurdụhum wa liyalbisụ
فعلوه فذرهم	fa’alụhu fa żar-hum
حرمت ظهورها	ḥurrimat ẓuhụruhā
سيجزيهم بما	sayajzīhim bimā
الأنعام خالصة	al-an’āmi khāliṣah
فيه شركاء	fīhi syurakā`
سيجزيهم وصفهم	sayajzīhim waṣfahum
حكيم عليم	ḥakīmun ‘alīm
قتلوا أولادهم	qatalū aulādahum
قد ضلوا	qad ḍallụ
أنشأ جنات معروشات	ansya`a jannātim ma’rụsyāt
أثمر وآتوا	aṡmara wa ātụ
يحب المسرفين	yuḥibbul-musrifīn
حمولة وفرشا	ḥamụlataw wa farsyā
خطوات الشيطان	khuṭuwātisy-syaiṭān
عدو مبين	‘aduwwum mubīn
ثمانية أزواج	ṡamāniyata azwāj
الضأن اثنين	aḍ-ḍa`niṡnain
الأنثيين أما اشتملت	al-unṡayaini ammasytamalat
نبئوني بعلم	nabbi`ụnī bi’ilm
البقر اثنين	al-baqariṡnaīn
أرحام الأنثيين	ar-ḥāmul-unṡayaīn
إذ وصاكم	iż waṣṣākum
ليضل الناس	liyuḍillan-nās
القوم الظالمين	al-qaumaẓ-ẓālimīn
لحم خنزير	laḥma khinzīr
غير باغ	gaira bāg
ذي ظفر	żī ẓufur
ما اختلط بعظم	makhtalaṭa bi’aẓm
جزيناهم ببغيهم	jazaināhum bibagyihim
وإنا لصادقون	wa innā laṣādiqụn
كذبوك فقل	każżabụka fa qul
يرد بأسه	yuraddu ba`suh
ذاقوا بأسنا	żāqụ ba`sanā
فتخرجوه لنا	fa tukhrijụhu lanā
إلا تخرصون	illā takhruṣụn
الحجة البالغة	al-ḥujjatul-bāligah
شاء لهداكم	syā`a lahadākum
تشهد معهم	tasy-had ma’ahum
بربهم يعدلون	birabbihim ya’dilụn
تشركوا به شيئا	tusyrikụ bihī syai`ā
من إملاق	min imlāq
نرزقكم وإياهم	narzuqukum wa iyyāhum
تقربوا الفواحش	taqrabul-fawāḥisy
تقتلوا النفس	taqtulun-nafs
ذلكم وصاكم	żālikum waṣṣākum
يبلغ أشده	yabluga asyuddah
وأوفوا الكيل	wa auful-kail
ذا قربى 	żā qurbā
وبعهد الله أوفوا	wa bi’ahdillāhi aufụ
ذلكم وصاكم	żālikum waṣṣākum
مستقيما فاتبعوه	mustaqīman fattabi’ụh
تتبعوا السبل	tattabi’us-subul
أحسن وتفصيلا	aḥsana wa tafṣīl
مبارك فاتبعوه	mubārakun fattabi’ụh
دراستهم لغافلين	dirāsatihim lagāfilīn
لكنا أهدى	lakunnā ahdā
وهدى ورحمة	wa hudaw wa raḥmah
وصدف عنها	wa ṣadafa ‘an-hā
سنجزي الذين	sanajzillażīn
أو يأتي ربك	au ya`tiya rabbuk
تكن آمنت	takun āmanat
قل انتظروا	qulintaẓirū
فرقوا دينهم	farraqụ dīnahum
ثم ينبئهم	ṡumma yunabbi`uhum
عشر أمثالها	‘asyru amṡālihā
جاء بالسيئة 	jā`a bis-sayyi`ah
إنني هداني	innanī hadānī
دينا قيما ملة	dīnang qiyamam millah
ونسكي ومحياي	wa nusukī wa maḥyāyā
لا شريك له	lā syarīka lah
أول المسلمين	awwalul-muslimīn
أبغي ربا	abgī rabbā
ولا تكسب	wa lā taksib
وازرة وزر	wāziratuw wizr
مرجعكم فينبئكم	marji’ukum fa yunabbi`ukum
خلائف الأرض	khalā`ifal-arḍ
سريع العقاب	sarī’ul-‘iqāb
وذكرى للمؤمنين	wa żikrā lil-mu`minīn
دونه أولياء	dụnihī auliyā`
قليلا ما تذكرون	qalīlam mā tażakkarụn
فجاءها بأسنا	fa jā`ahā ba`sunā
كنا ظالمين	kunnā ẓālimīn
ولنسألن المرسلين	wa lanas`alannal-mursalīn
كنا غائبين	kunnā gā`ibīn
والوزن يومئذ	wal-waznu yauma`iż
فمن ثقلت	fa man ṡaqulat
ومن خفت	wa man khaffat
ولقد مكناكم	wa laqad makkannākum
قليلا ما تشكرون	qalīlam mā tasykurụn
ثم صورناكم	ṡumma ṣawwarnākum
من الساجدين	minas-sājidīn
تسجد إذ أمرتك	tasjuda iż amartuk
خير منه	khairum min-h
خلقته من طين	khalaqtahụ min ṭīn
تتكبر فيها	tatakabbara fīhā
يوم يبعثون	yaumi yub’aṡụn
من المنظرين	minal-munẓarīn
أغويتني لأقعدن	agwaitanī la`aq’udann
وعن شمائلهم	wa ‘an syamā`ilihim
تجد أكثرهم	tajidu akṡarahum
مذءوما مدحورا	maż`ụmam mad-ḥụrā
لأملأن جهنم	la`amla`anna jahannam
حيث شئتما	ḥaiṡu syi`tumā
فوسوس لهما	fa waswasa lahumā
لمن الناصحين	laminan-nāṣiḥīn
فدلاهما بغرور	fa dallāhumā bigurụr
ذاقا الشجرة	żāqasy-syajarah
وناداهما ربهما	wa nādāhumā rabbuhumā
وترحمنا لنكونن	wa tar-ḥamnā lanakụnann
قال اهبطوا	qālahbiṭụ
مستقر ومتاع	mustaqarruw wa matā’
فيها تحيون	fīhā taḥyaun
سوآتكم وريشا	sau`ātikum warīsyā
ولباس التقوى	wa libāsut-taqwā
لعلهم يذكرون	la’allahum yażżakkarụn
ليريهما سوآتهما	liyuriyahumā sau`ātihimā
إنه يراكم	innahụ yarākum
جعلنا الشياطين	ja’alnasy-syayāṭīn
فعلوا فاحشة	fa’alụ fāḥisyah
يأمر بالفحشاء	ya`muru bil-faḥsyā`
أتقولون	a taqụlụn
ربي بالقسط	rabbī bil-qisṭ
وادعوه مخلصين	wad’ụhu mukhliṣīn
بدأكم تعودون	bada`akum ta’ụdụn
إنهم اتخذوا	innahumuttakhażụ
تسرفوا	tusrifụ
يحب المسرفين	innahụ lā yuḥibbul-musrifīn
لعباده والطيبات	li’ibādihī waṭ-ṭayyibāt
الدنيا خالصة	ad-dun-yā khāliṣah
كذلك نفصل	każālika nufaṣṣil
أمة أجل	ummatin ajal
يستأخرون ساعة	yasta`khirụna sā’ah
فمن اتقى	fa manittaqā
بآياتنا واستكبروا	bi`āyātinā wastakbarụ
كذبا أو كذب	każiban au każżab
ينالهم نصيبهم	yanaluhum naṣībuhum
رسلنا يتوفونهم	rusulunā yatawaffaunahum
ضلوا عنا وشهدوا	ḍallụ ‘annā wa syahidụ
لعنت أختها	la’anat ukhtahā
عذابا ضعفا	‘ażāban ḍi’fā
لكل ضعف	likullin ḍi’f
أولاهم لأخراهم	ụlāhum li`ukhrāhum
فوقهم غواش	fauqihim gawāsy
نجزي الظالمين	najziẓ-ẓālimīn
نكلف نفسا	nukallifu nafsā
غل تجري	gillin tajrī
هدانا لهذا	hadānā lihāżā
لنهتدي لولا	linahtadiya lau lā
ربنا بالحق	rabbinā bil-ḥaqq
الجنة أورثتموها	al-jannatu ụriṡtumụhā
ونادى أصحاب	wa nādā aṣ-ḥāb
قالوا نعم	qālụ na’am
فأذن مؤذن	fa ażżana mu`ażżin
ويبغونها عوجا	wa yabgụnahā ‘iwajā
بالآخرة كافرون	bil-ākhirati kāfirụn
وبينهما حجاب	wa bainahumā ḥijāb
الأعراف رجال	al-a’rāfi rijāl
أن سلام عليكم	an salāmun ‘alaikum
لم يدخلوها	lam yadkhulụhā
صرفت أبصارهم تلقاء	ṣurifat abṣāruhum tilqā`
كنتم تستكبرون	kuntum tastakbirụn
أهؤلاء الذين أقسمتم	a hā`ulā`illażīna aqsamtum
ادخلوا الجنة	udkhulul-jannah
 أن أفيضوا علينا	an afīḍụ ‘alainā
حرمهما على الكافرين	ḥarramahumā ‘alal-kāfirīn
لهوا ولعبا 	lahwaw wa la’ibā
ننساهم كما نسوا	nansāhum kamā nasụ
بكتاب فصلناه	bikitābin faṣṣalnāh
إلا تأويله	illā ta`wīlah
يأتي تأويله	ya`tī ta`wīluh
من شفعاء فيشفعوا	min syufa’ā`a fa yasyfa’ụ
كانوا يفترون	kānụ yaftarụn
ستة أيام	sittati ayyām
يطلبه حثيثا	yaṭlubuhụ ḥaṡīṡā
تبارك الله	tabārakallāh
تضرعا وخفية	taḍarru’aw wa khufyah
يحب المعتدين	yuḥibbul-mu’tadīn
خوفا وطمعا	khaufaw wa ṭama’ā
قريب من المحسنين	qarībum minal-muḥsinīn
بين يدي رحمته	baina yadai raḥmatih
ثقالا سقناه	ṡiqālan suqnāh
نخرج الموتى	nukhrijul-mautā
والبلد الطيب	wal-baladuṭ-ṭayyib
خبث إلا نكدا	khabuṡa illā nakidā
قومه فقال	qaumihī fa qāl
إني أخاف	innī akhāf
إنا لنراك	innā lanarāk
ضلالة ولكني	ḍalālatuw wa lākinnī
أبلغكم رسالات	uballigukum risālāt
أوعجبتم أن جاءكم	a wa ‘ajibtum an jā`akum
فكذبوه فأنجيناه	fa każżabụhu fa anjaināh
قوما عمين	qauman ‘amīn
عاد أخاهم هودا	‘ādin akhāhum hụdā
إله غيره	ilāhin gairuh
سفاهة وإنا لنظنك	safāhatiw wa innā lanaẓunnuk
سفاهة ولكني	safāhatuw wa lākinnī
ناصح أمين	nāṣiḥun amīn
لينذركم	liyunżirakum
الخلق بسطة	al-khalqi baṣṭah
فاذكروا آلاء	fażkurū ālā`
يعبد آباؤنا	ya’budu ābā`unā
فأتنا بما تعدنا	fa`tinā bimā ta’idunā
رجس وغضب	rijsuw wa gaḍab
من سلطان	min sulṭān
فانتظروا إني	fantaẓirū innī
وقطعنا دابر	wa qaṭa’nā dābir
أخاهم صالحا	akhāhum ṣāliḥā
قوم اعبدوا الله ما	qaumi’budullāha mā
جاءتكم بينة	jā`atkum bayyinah
تمسوها بسوء	tamassụhā bisū`
قصورا وتنحتون	quṣụraw wa tan-ḥitụn
تعثوا في	ta’ṡau fī
للذين استضعفوا	lillażīnastuḍ’ifụ
بما أرسل به	bimā ursila bih
بالذي آمنتم	billażī āmantum
فعقروا الناقة	fa ‘aqarun-nāqah
فأخذتهم الرجفة	fa akhażat-humur-rajfah
تحبون الناصحين	tuḥibbụnan-nāṣiḥīn
أتأتون الفاحشة	a ta`tụnal-fāḥisyah
لتأتون الرجال	lata`tụnar-rijāl
قوم مسرفون	qaumum musrifụn
جواب قومه	jawāba qaumih
إنهم أناس	innahum unās
إلا امرأته	illamra`atah
وأمطرنا مطرا	wa amṭarnā maṭarā
عاقبة المجرمين	‘āqibatul-mujrimīn
أخاهم شعيبا	akhāhum syu’aibā
قال يا قوم	qāla yā qaum
فأوفوا الكيل	fa auful-kail
ذلكم خير	żālikum khair
توعدون وتصدون	tụ’idụna wa taṣuddụn
قليلا فكثركم	qalīlan fa kaṡṡarakum
وطائفة لم يؤمنوا	wa ṭā`ifatul lam yu`minụ
خير الحاكمين	khairul-ḥākimīn
لنخرجنك يا شعيب	lanukhrijannaka yā syu’aib
كنا كارهين	kunnā kārihīn
قد افترينا	qadiftarainā
أن نعود فيها	an na’ụda fīhā
وسع ربنا	wasi’a rabbunā
على الله توكلنا	‘alallāhi tawakkalnā
ربنا افتح بيننا	rabbanaftaḥ bainanā
لئن اتبعتم شعيبا	la`inittaba’tum syu’aibā
الرجفة فأصبحوا	ar-rajfatu fa aṣbaḥụ
كذبوا شعيبا كأن لم	każżabụ syu’aibang ka`al lam
ونصحت لكم	wa naṣaḥtu lakum
فكيف آسى	fa kaifa āsā
أهلها بالبأساء	ahlahā bil-ba`sā`
مكان السيئة الحسنة	makānas-sayyi`atil-ḥasanah
واتقوا لفتحنا	wattaqau lafataḥnā
بياتا وهم نائمون	bayātaw wa hum nā`imụn
ضحى وهم يلعبون	ḍuḥaw wa hum yal’abụn
أفأمنوا مكر الله	a fa aminụ makrallāh
يأمن مكر	ya`manu makr
يرثون الأرض	yariṡụnal-arḍ
ونطبع على	wa naṭba’u ‘alā
القرى نقص عليك	al-qurā naquṣṣu ‘alaik
رسلهم بالبينات	rusuluhum bil-bayyināt
كذبوا من قبل	każżabụ ming qabl
كذلك يطبع الله	każālika yaṭba’ullāh
وجدنا لأكثرهم	wajadnā li`akṡarihim
أكثرهم لفاسقين	akṡarahum lafāsiqīn
وملئه فظلموا بها	wa mala`ihī fa ẓalamụ bihā
عاقبة المفسدين	‘āqibatul-mufsidīn
موسى يا فرعون	mụsā yā fir’aun
حقيق على	ḥaqīqun ‘alā
قد جئتكم ببينة من	qad ji`tukum bibayyinatim min
جئت بآية فأت بها	ji`ta bi`āyatin fa`ti bihā
ثعبان مبين	ṡu’bānum mubīn
بيضاء للناظرين	baiḍā`u lin-nāẓirīn
لساحر عليم	lasāḥirun ‘alīm
من أرضكم	min arḍikum
فماذا تأمرون	fa māżā ta`murụn
المدائن حاشرين	al-madā`ini ḥāsyirīn
يأتوك بكل	ya`tụka bikull
نحن الغالبين	naḥnul-gālibīn
لمن المقربين	laminal-muqarrabīn
نحن الملقين	naḥnul-mulqīn
قال ألقوا	qāla alqụ
واسترهبوهم وجاءوا	wastar-habụhum wa jā`ụ
ألق عصاك	alqi ‘aṣāk
تلقف ما يأفكون	talqafu mā ya`fikụn
فوقع الحق	fa waqa’al-ḥaqq
وانقلبوا صاغرين	wangqalabụ ṣāgirīn
وألقي السحرة	wa ulqiyas-saḥarah
قالوا آمنا	qālū āmannā
رب موسى وهارون	rabbi mụsā wa hārụn
أن آذن لكم	an āżana lakum
لمكر مكرتموه	lamakrum makartumụh
فسوف تعلمون	fa saufa ta’lamụn
لأصلبنكم أجمعين	la`uṣallibannakum ajma’īn
ربنا منقلبون	rabbinā mungqalibụn
آمنا بآيات	āmannā bi`āyāt
صبرا وتوفنا	ṣabraw wa tawaffanā
ويذرك وآلهتك	wa yażaraka wa ālihatak
ونستحيي نساءهم	wa nastaḥyī nisā`ahum
فوقهم قاهرون	fauqahum qāhirụn
لقومه استعينوا	liqaumihista’īnụ billāhi waṣbirụ
إن الأرض لله	innal-arḍa lillāh
يورثها من يشاء	yụriṡuhā may yasyā`
والعاقبة للمتقين	wal-‘āqibatu lil-muttaqīn
قالوا أوذينا	qālū ụżīnā
عدوكم ويستخلفكم	‘aduwwakum wa yastakhlifakum
بالسنين ونقص	bis-sinīna wa naqṣ
جاءتهم الحسنة	jā`at-humul-ḥasanah
سيئة يطيروا	sayyi`atuy yaṭṭayyarụ
إنما طائرهم	innamā ṭā`iruhum
مهما تأتنا	mahmā ta`tinā
والقمل والضفادع 	wal-qummala waḍ-ḍafādi’
فاستكبروا	fastakbarụ
وقع عليهم الرجز	waqa’a ‘alaihimur-rijz
عنا الرجز	‘annar-rijz
هم ينكثون	hum yangkuṡụn
فانتقمنا منهم فأغرقناهم	fantaqamnā min-hum fa agraqnāhum
وأورثنا القوم	wa auraṡnal-qaum
ربك الحسنى	rabbikal-ḥusnā
يصنع فرعون	yaṣna’u fir’aun
وجاوزنا ببني	wa jāwaznā bibanī
إلها كما لهم	ilāhang kamā lahum
إن هؤلاء متبر	inna hā`ulā`i mutabbar
أغير الله أبغيكم	a gairallāhi abgīkum
يسومونكم سوء العذاب	yasụmụnakum sū`al-‘ażāb
ويستحيون نساءكم 	wa yastaḥyụna nisā`akum
ذلكم بلاء من	żālikum balā`um min
بعشر فتم ميقات	bi’asyrin fa tamma mīqāt
قومي وأصلح	qaumī wa aṣliḥ
لميقاتنا وكلمه	limīqātinā wa kallamah
فإن استقر مكانه	fa inistaqarra makānah
دكا وخر موسى صعقا	dakkaw wa kharra mụsā ṣa’iqā
فلما أفاق	fa lammā afāq
برسالاتي وبكلامي	birisālātī wa bikalāmī
موعظة وتفصيلا	mau’iẓataw wa tafṣīl
فخذها بقوة وأمر	fa khuż-hā biquwwatiw wa`mur
سأريكم دار الفاسقين	sa`urīkum dāral-fāsiqīn
سأصرف عن آياتي	sa aṣrifu ‘an āyātī
وإن يروا كل آية	wa iy yarau kulla āyah
سبيل الرشد	sabīlar-rusyd
سبيل الغي	sabīlal-gayy
عنها غافلين	‘an-hā gāfilīn
حبطت أعمالهم	ḥabiṭat a’māluhum
هل يجزون	hal yujzaun
عجلا جسدا له خوار	‘ijlan jasadal lahụ khuwār
يهديهم سبيلا	yahdīhim sabīlā
اتخذوه	ittakhażụh
قد ضلوا	qad ḍallụ
غضبان أسفا	gaḍbāna asifā
أعجلتم أمر ربكم	a ‘ajiltum amra rabbikum
أخذ برأس أخيه	akhaża bira`si akhīh
القوم استضعفوني	al-qaumastaḍ’afụnī
لأخي وأدخلنا	lī wa li`akhī wa adkhilnā
إن الذين اتخذوا العجل سينالهم	innallażīnattakhażul-‘ijla sayanāluhum
نجزي المفترين	najzil-muftarīn
عملوا السيئات	‘amilus-sayyi`āt
أخذ الألواح	akhażal-alwāḥ
سبعين رجلا لميقاتنا	sab’īna rajulal limīqātinā
أخذتهم الرجفة	akhażat-humur-rajfah
فعل السفهاء منا	fa’alas-sufahā`u minnā
إلا فتنتك	illā fitnatuk
تشاء وتهدي	tasyā`u wa tahdī
خير الغافرين	khairul-gāfirīn
إنا هدنا إليك	innā hudnā ilaīk
عذابي أصيب	‘ażābī uṣīb
ورحمتي وسعت	wa raḥmatī wasi’at
فسأكتبها للذين	fa sa`aktubuhā lillażīn
النبي الأمي	an-nabiyyal-ummī
وعزروه ونصروه	wa ‘azzarụhu wa naṣarụh
جميعا الذي	jamī’anillażī
وكلماته واتبعوه	wa kalimātihī wattabi’ụh
وبه يعدلون	wa bihī ya’dilụn
أسباطا أمما	asbāṭan umamā
إذ استسقاه	iżistasqāh
فانبجست	fambajasat
أناس مشربهم	unāsim masyrabahum
المن والسلوى	al-manna was-salwā
من طيبات ما رزقناكم	min ṭayyibāti mā razaqnākum
ولكن كانوا أنفسهم	wa lāking kānū anfusahum
لهم اسكنوا	lahumuskunụ
سنزيد المحسنين	sanazīdul-muḥsinīn
رجزا من السماء	rijzam minas-samā`
حاضرة البحر	hāḍiratal-baḥr
سبتهم شرعا	sabtihim syurra’ā
كذلك نبلوهم	każālika nablụhum
تعظون قوما	ta’iẓụna qaumā
قالوا معذرة	qālụ ma’żirah
بعذاب بئيس	bi’ażābim ba`īs
قردة خاسئين	qiradatan khāsi`īn
تأذن ربك ليبعثن	ta`ażżana rabbuka layab’aṡann
لسريع العقاب	lasarī’ul-‘iqāb
وقطعناهم أمما	wa qaṭṭa’nāhum umamā
بالحسنات والسيئات	bil-ḥasanāti was-sayyi`āt
خلف ورثوا	khalfuw wariṡụ
عرض مثله يأخذوه	‘araḍum miṡluhụ ya`khużụh
ودرسوا ما فيه	wa darasụ mā fīh
والدار الآخرة	wad-dārul-ākhirah
يمسكون بالكتاب	yumassikụna bil-kitāb
أجر المصلحين	ajral-muṣliḥīn
كأنه ظلة	ka`annahụ ẓullah
خذوا ما آتيناكم	khużụ mā ātainākum
ظهورهم ذريتهم وأشهدهم	ẓuhụrihim żurriyyatahum wa asy-hadahum
ألست بربكم	a lastu birabbikum
بلى شهدنا	balā syahidnā
هذا غافلين	hāżā gāfilīn
ذرية من بعدهم	żurriyyatam mim ba’dihim
فعل المبطلون	fa’alal-mubṭilụn
من الغاوين	minal-gāwīn
ولو شئنا لرفعناه	walau syi`nā larafa’nāh
فمثله كمثل الكلب	fa maṡaluhụ kamaṡalil-kalb
تتركه يلهث	tatruk-hu yal-haṡ
فاقصص القصص	faqṣuṣil-qaṣaṣ
ساء مثلا القوم	sā`a maṡalanil-qaum
فهو المهتدي	fa huwal-muhtadī
يضلل فأولئك	yuḍlil fa ulā`ik
ذرأنا لجهنم	żara`nā lijahannam
هم أضل	hum aḍall
يلحدون في أسمائه	yul-ḥidụna fī asmā`ih
يهدون بالحق	yahdụna bil-ḥaqq
بآياتنا سنستدرجهم	bi`āyātinā sanastadrijuhum
وأملي لهم 	wa umlī lahum
كيدي متين	kaidī matīn
يتفكروا ما بصاحبهم	yatafakkarụ mā biṣāḥibihim
نذير مبين	nażīrum mubīn
قد اقترب	qadiqtarab
طغيانهم يعمهون	ṭugyānihim ya’mahụn
أيان مرساها	ayyāna mursāhā
عند ربي	‘inda rabbī
يجليها لوقتها	yujallīhā liwaqtihā
ثقلت في	ṡaqulat fī
لا تأتيكم إلا بغتة	lā ta`tīkum illā bagtah
حفي عنها	ḥafiyyun ‘an-hā
ولكن أكثر الناس	wa lākinna akṡaran-nās
لنفسي نفعا ولا ضرا	linafsī naf’aw wa lā ḍarrā
لاستكثرت من الخير	lastakṡartu minal-khaīr
مسني السوء	massaniyas-sū`
زوجها ليسكن	zaujahā liyaskun
حملا خفيفا فمرت	ḥamlan khafīfan fa marrat
فلما أثقلت دعوا	fa lammā aṡqalad da’awā
آتاهما صالحا	ātāhumā ṣāliḥā
عما يشركون	‘ammā yusyrikụn
أيشركون ما	a yusyrikụna mā
يستطيعون لهم نصرا	yastaṭī’ụna lahum naṣrā
لا يتبعوكم 	lā yattabi’ụkum
أدعوتموهم صامتون	a da’autumụhum ṣāmitụn
فادعوهم فليستجيبوا	fad’ụhum falyastajībụ
أرجل يمشون بها	arjuluy yamsyụna bihā
قل ادعوا شركاءكم	qulid’ụ syurakā`akum
يتولى الصالحين	yatawallaṣ-ṣāliḥīn
يستطيعون نصركم	yastaṭī’ụna naṣrakum
تدعوهم إلى الهدى	tad’ụhum ilal-hudā
وتراهم ينظرون	wa tarāhum yanẓurụn
خذ العفو وأمر	khużil-‘afwa wa`mur
وإما ينزغنك	wa immā yanzagannak
إنه سميع عليم	innahụ samī’un ‘alīm
مسهم طائف	massahum ṭā`if
وإخوانهم يمدونهم	wa ikhwānuhum yamuddụnahum
لولا اجتبيتها	lau lajtabaitahā
إنما أتبع ما	innamā attabi’u mā
هذا بصائر	hāżā baṣā`ir
قرئ القرآن	quri`al-qur`ān
تضرعا وخيفة	taḍarru’aw wa khīfah
عبادته ويسبحونه	‘ibādatihī wa yusabbiḥụnah
عن الأنفال	‘anil-anfāl
قل الأنفال لله	qulil-anfālu lillāh
وأصلحوا ذات	wa aṣliḥụ żāt
آياته زادتهم	iāyātuhụ zādat-hum
يقيمون الصلاة	yuqīmụnaṣ-ṣalāh
هم المؤمنون حقا	humul-mu`minụna ḥaqqā
مغفرة ورزق كريم	magfiratuw wa rizqung karīm
المؤمنين لكارهون	al-mu`minīna lakārihụn
تبين كأنما يساقون	tabayyana ka`annamā yusāqụn
إحدى الطائفتين	iḥdaṭ-ṭā`ifatain
ليحق الحق	liyuḥiqqal-ḥaqq
ممدكم بألف	mumiddukum bi`alf
بشرى ولتطمئن	busyrā wa litaṭma`inn
وما النصر إلا	wa man-naṣru illā
يغشيكم النعاس	yugasysyīkumun-nu’ās
فثبتوا الذين	fa ṡabbitullażīn
فوق الأعناق	fauqal-a’nāq
بأنهم شاقوا	bi`annahum syāqqụ
ذلكم فذوقوه	żālikum fa żụqụh
كفروا زحفا	kafarụ zaḥfā
متحرفا لقتال	mutaḥarrifal liqitāl
رميت إذ رميت	ramaita iż ramait
بلاء حسنا	balā`an ḥasanā
كيد الكافرين	kaidil-kāfirīn
إن تستفتحوا فقد	in tastaftiḥụ fa qad
وإن تنتهوا	wa in tantahụ
وإن تعودوا نعد	wa in ta’ụdụ na’ud
شيئا ولو كثرت	syai`aw walau kaṡurat
تولوا عنه	tawallau ‘an-h
ولا تكونوا كالذين	wa lā takụnụ kallażīn
إن شر الدواب	inna syarrad-dawābb
خيرا لأسمعهم	khairal la`asma’ahum
ولو أسمعهم	walau asma’ahum
لما يحييكم	limā yuḥyīkum
يحول بين المرء	yaḥụlu bainal-mar`
فتنة لا تصيبن	fitnatal lā tuṣībann
قليل مستضعفون	qalīlum mustaḍ’afụn
وتخونوا أماناتكم	wa takhụnū amānātikum
وأولادكم فتنة	wa aulādukum fitnah
فرقانا ويكفر	furqānaw wa yukaffir
يقتلوك أو يخرجوك	yaqtulụka au yukhrijụk
يمكرون يمكر الله	yamkurụna yamkurullāh
أساطير الأولين	asāṭīrul-awwalīn
أو ائتنا بعذاب	awi`tinā bi’ażāb
ليعذبهم وأنت فيهم	liyu’ażżibahum wa anta fīhim
معذبهم يستغفرون	mu’ażżibahum yastagfirụn
كانوا أولياءه	kānū auliyā`ah
أولياؤه إلا المتقون	auliyā`uhū illal-muttaqụn
مكاء وتصدية	mukā`aw wa taṣdiyah
ينفقون أموالهم	yunfiqụna amwālahum
حسرة ثم يغلبون	ḥasratan ṡumma yuglabụn
جهنم يحشرون	jahannama yuḥsyarụn
ليميز الله الخبيث	liyamīzallāhul-khabīṡ
قد سلف	qad salaf
مضت سنت الأولين	maḍat sunnatul-awwalīn
ويكون الدين كله	wa yakụnad-dīnu kulluh
فإن انتهوا فإن	fa inintahau fa inn
وإن تولوا فاعلموا	wa in tawallau fa’lamū
ونعم النصير	wa ni’man-naṣīr
يوم التقى الجمعان	yaumaltaqal jam’ān
بالعدوة القصوى	bil-‘udwatil-quṣwā
تواعدتم لاختلفتم	tawā’attum lakhtalaftum
منامك قليلا	manāmika qalīlā
كثيرا لفشلتم	kaṡīral lafasyiltum
قليلا ويقللكم	qalīlaw wa yuqallilukum
لقيتم فئة فاثبتوا	laqītum fi`atan faṡbutụ
فتفشلوا وتذهب	fa tafsyalụ wa taż-hab
بطرا ورئاء الناس	baṭaraw wa ri`ā`an-nās
لا غالب لكم	lā gāliba lakum
تراءت الفئتان	tarā`atil-fi`atān
مرض غر هؤلاء	maraḍun garra hā`ulā`
يتوكل على الله	yatawakkal ‘alallāh
ترى إذ يتوفى	tarā iż yatawaffī
عذاب الحريق	‘ażābal-ḥarīq
ليس بظلام للعبيد	laisa biẓallāmil lil-‘abīd
فأخذهم الله بذنوبهم	fa akhażahumullāhu biżunụbihim
قوي شديد	qawiyyun syadīd
مغيرا نعمة	mugayyiran ni’mah
وكل كانوا ظالمين	wa kullung kānụ ẓālimīn
عاهدت منهم عهدهم	‘āhatta min-hum ‘ahdahum
فإما تثقفنهم	fa immā taṡqafannahum
خيانة فانبذ	khiyānatan fambiż
يحب الخائنين	yuḥibbul-khā`inīn
كفروا سبقوا	kafarụ sabaqụ
لا يعجزون	lā yu’jizụn
ما استطعتم من قوة	mastaṭa’tum ming quwwah
لا تعلمونهم	lā ta’lamụnahum
الله يعلمهم	allāhu ya’lamuhum
يوف إليكم	yuwaffa ilaikum
جنحوا للسلم	janaḥụ lis-salm
أن يخدعوك حسبك	ay yakhda’ụka ḥasbak
أيدك بنصره	ayyadaka binaṣrih
لو أنفقت ما	lau anfaqta mā
ومن اتبعك	wa manittaba’ak
حرض المؤمنين	ḥarriḍil-mu`minīn
صابرون يغلبوا مائتين	ṣābirụna yaglibụ mi`ataīn
مائة يغلبوا ألفا	mi`atuy yaglibū alfā
الآن خفف	al-āna khaffaf
صابرة يغلبوا مائتين	ṣābiratuy yaglibụ mi`ataīn
ألف يغلبوا ألفين	alfuy yaglibū alfain
أسرى حتى يثخن	asrā ḥattā yuṡkhin
تريدون عرض	turīdụna ‘araḍ
سبق لمسكم	sabaqa lamassakum
غنمتم حلالا	ganimtum ḥalālā
من الأسرى	minal-asrā
يريدوا خيانتك	yurīdụ khiyānatak
آووا ونصروا	āwaw wa naṣarū
من ولايتهم	miw walāyatihim
وإن استنصروكم	wa inistanṣarụkum
أولياء بعض	auliyā`u ba’ḍ
وفساد كبير	wa fasādung kabīr
ونصروا أولئك	wa naṣarū ulā`ik
وأولو الأرحام	wa ulul-ar-ḥām
عاهدتم من المشركين	‘āhattum minal-musyrikīn
أربعة أشهر	arba’ata asy-hur
يوم الحج الأكبر	yaumal-ḥajjil-akbar
غير معجزي الله	gairu mu’jizillāh
ينقصوكم شيئا	yangquṣụkum syai`ā
يحب المتقين	yuḥibbul muttaqīn
فإذا انسلخ الأشهر	fa iżansalakhal-asy-hur
فخلوا سبيلهم	fa khallụ sabīlahum
المشركين استجارك	al-musyrikīnastajārak
فما استقاموا	famastaqāmụ
ولا ذمة	wa lā żimmah
يرضونكم وتأبى	yurḍụnakum wa ta`bā
وأكثرهم فاسقون	wa akṡaruhum fāsiqụn
اشتروا بآيات	isytarau bi`āyāt
يرقبون في مؤمن	yarqubụna fī mu`min
الزكاة فإخوانكم	az-zakāta fa ikhwānukum
فقاتلوا أئمة	fa qātilū a`immah
وهموا بإخراج	wa hammụ bi`ikhrāj
أحق أن تخشوه	aḥaqqu an takhsyauh
ويشف صدور	wa yasyfi ṣudụr
ويذهب غيظ	wa yuż-hib gaiẓ
حسبتم أن تتركوا	ḥasibtum an tutrakụ
أن يعمروا مساجد	ay ya’murụ masājid
حبطت	ḥabiṭat
يعمر مساجد	ya’muru masājid
فعسى أولئك	fa ‘asā ulā`ik
سقاية الحاج	siqāyatal-ḥājj
أعظم درجة	a’ẓamu darajah
الفائزون	al-fā`izụn
ورضوان وجنات	wa riḍwāniw wa jannāt
إن استحبوا الكفر	inistaḥabbul-kufr
وأموال اقترفتموها	wa amwāluniqtaraftumụhā
مواطن كثيرة	mawāṭina kaṡīrah
نجس فلا يقربوا	najasun fa lā yaqrabụ
عيلة فسوف يغنيكم	‘ailatan fa saufa yugnīkum
يدينون دين	yadīnụna dīn
يضاهئون قول	yuḍāhi`ụna qaul
أنى يؤفكون	annā yu`fakụn
ورهبانهم أربابا	wa ruhbānahum arbābā
ليعبدوا إلها	liya’budū ilāhā
يطفئوا نور	yuṭfi`ụ nụr
أرسل رسوله	arsala rasụlah
الأحبار والرهبان	al-aḥbāri war-ruhbān
يكنزون الذهب	yaknizụnaż-żahab
بها جباههم	bihā jibāhuhum
كنزتم لأنفسكم	kanaztum li`anfusikum
عدة الشهور	‘iddatasy-syuhụr
إنما النسيء زيادة	innaman-nasī`u ziyādah
لكم انفروا	lakumunfirụ
أرضيتم بالحياة	a raḍītum bil-ḥayāh
متاع الحياة	matā’ul-ḥayāh
ويستبدل قوما غيركم	wa yastabdil qauman gairakum
تنصروه فقد نصره	tanṣurụhu fa qad naṣarah
وأيده بجنود	wa ayyadahụ bijunụd
هي العليا	hiyal-‘ulyā
انفروا خفافا وثقالا	infirụ khifāfaw wa ṡiqālā
وسفرا قاصدا لاتبعوك	wa safarang qāṣidal lattaba’ụk
لو استطعنا لخرجنا	lawistaṭa’nā lakharajnā
يهلكون أنفسهم	yuhlikụna anfusahum
إنهم لكاذبون	innahum lakāżibụn
عفا الله عنك	‘afallāhu ‘angk
وتعلم الكاذبين	wa ta’lamal-kāżibīn
لا يستأذنك الذين	lā yasta`żinukallażīn
عليم بالمتقين	‘alīmum bil-muttaqīn
ريبهم يترددون	raibihim yataraddadụn
ولو أرادوا الخروج	walau arādul-khurụj
ولأوضعوا خلالكم	wa la`auḍa’ụ khilālakum
سماعون لهم	sammā’ụna lahum
لقد ابتغوا الفتنة	laqadibtagawul-fitnah
يقول ائذن لي	yaqụlu`żal lī
الفتنة سقطوا	al-fitnati saqaṭụ
جهنم لمحيطة	jahannama lamuḥīṭah
حسنة تسؤهم	ḥasanatun tasu`hum
تصبك مصيبة يقولوا	tuṣibka muṣībatuy yaqụlụ
لن يصيبنا	lay yuṣībanā
هو مولانا	huwa maulānā
تربصون بنا	tarabbaṣụna binā
ونحن نتربص	wa naḥnu natarabbaṣ
قل أنفقوا طوعا	qul anfiqụ ṭau’ā
قوما فاسقين	qauman fāsiqīn
نفقاتهم إلا أنهم	nafaqātuhum illā annahum
فلا تعجبك	fa lā tu’jibk
وتزهق أنفسهم	wa taz-haqa anfusuhum
ويحلفون بالله	wa yaḥlifụna billāh
قوم يفرقون	qaumuy yafraqụn
ملجأ أو مغارات	malja`an au magārāt
يلمزك في الصدقات	yalmizuka fiṣ-ṣadaqāt
فإن أعطوا منها	fa in u’ṭụ min-hā
سيؤتينا	sayu`tīnā
الرقاب والغارمين	ar-riqābi wal-gārimīn
يؤذون النبي	yu`żụnan-nabī
ويؤمن للمؤمنين	wa yu`minu lil-mu`minīn
يؤذون رسول	yu`żụna rasụl
لكم ليرضوكم يرضوه	lakum liyurḍụkum yurḍụh
من يحادد	may yuḥādid
الخزي العظيم	al-khizyul-‘aẓīm
يحذر المنافقون	yaḥżarul-munāfiqụn
قل استهزئوا	qulistahzi`ụ
مخرج ما تحذرون	mukhrijum mā taḥżarụn
كنا نخوض ونلعب	kunnā nakhụḍu wa nal’ab
كنتم تستهزئون	kuntum tastahzi`ụn
تعتذروا قد كفرتم	ta’tażirụ qad kafartum
نعف عن طائفة	na’fu ‘an ṭā`ifah
المنافقون والمنافقات	al-munāfiqụna wal-munāfiqāt
ويقبضون أيديهم	wa yaqbiḍụna aidiyahum
نسوا الله فنسيهم	nasullāha fa nasiyahum
إن المنافقين هم	innal-munāfiqīna hum
هي حسبهم	hiya ḥasbuhum
ولعنهم الله	wa la’anahumullāh
عذاب مقيم	‘ażābum muqīm
قوة وأكثر أموالا	quwwataw wa akṡara amwālā
فاستمتعتم بخلاقكم	fastamta’tum bikhalāqikum
مدين والمؤتفكات	madyana wal-mu`tafikāt
أتتهم رسلهم	atat-hum rusuluhum
ليظلمهم ولكن	liyaẓlimahum wa lākin
والمؤمنون والمؤمنات	wal-mu`minụna wal-mu`mināt
عن المنكر ويقيمون	‘anil-mungkari wa yuqīmụn
سيرحمهم الله	sayar-ḥamuhumullāh
ومساكن طيبة	wa masākina ṭayyibah
ورضوان من	wa riḍwānum min
والمنافقين واغلظ	wal-munāfiqīna wagluẓ
ومأواهم جهنم	wa ma`wāhum jahannam
يحلفون بالله	yaḥlifụna billāh
إسلامهم وهموا	islāmihim wa hammụ
أن أغناهم	an agnāhum
فإن يتوبوا يك	fa iy yatụbụ yak
يتولوا يعذبهم	yatawallau yu’ażżib-hum
لنصدقن ولنكونن	lanaṣṣaddaqanna wa lanakụnann
بخلوا به وتولوا	bakhilụ bihī wa tawallaw
فأعقبهم نفاقا	fa a’qabahum nifāqā
سرهم ونجواهم	sirrahum wa najwāhum
يلمزون المطوعين	yalmizụnal-muṭṭawwi’īn
سخر الله	sakhirallāh
استغفر لهم	istagfir lahum
لا تستغفر لهم	lā tastagfir lahum
سبعين مرة	sab’īna marrah
بمقعدهم خلاف	bimaq’adihim khilāfā
أشد حرا	asyaddu ḥarrā
كانوا يفقهون	kānụ yafqahụn
فليضحكوا وليبكوا	falyaḍ-ḥakụ walyabkụ
فاستأذنوك للخروج	fasta`żanụka lil-khurụj
رضيتم بالقعود	raḍītum bil-qu’ụd
فاقعدوا	faq’udụ
تقم على قبره	taqum ‘alā qabrih
تعجبك أموالهم	tu’jibka amwāluhum
الدنيا وتزهق	ad-dun-yā wa taz-haq
أولو الطول	uluṭ-ṭaul
الخوالف وطبع	al-khawālifi wa ṭubi’
معه جاهدوا	ma’ahụ jāhadụ
الأعراب ليؤذن	al-a’rābi liyu`żan
سيصيب الذين	sayuṣībullażīn
الضعفاء ولا	aḍ-ḍu’afā`i wa lā 
المحسنين من سبيل	al-muḥsinīna min sabīl
أتوك لتحملهم	atauka litaḥmilahum
يستأذنونك أغنياء	yasta`żinụnaka agniyā`
الخوالف وطبع	al-khawālifi wa ṭaba’
يعتذرون إليكم	ya’tażirụna ilaikum
والشهادة فينبئكم	wasy-syahādati fa yunabbi`ukum
إذا انقلبتم إليهم	iżangqalabtum ilaihim
فأعرضوا عنهم	fa a’riḍụ ‘an-hum
رجس ومأواهم	rijsuw wa ma`wāhum
لترضوا عنهم	litarḍau ‘an-hum
فإن ترضوا عنهم	fa in tarḍau ‘an-hum
أشد كفرا ونفاقا	asyaddu kufraw wa nifāqā
مغرما ويتربص	magramaw wa yatarabbaṣ
دائرة السوء	dā`iratus-saụ`
ينفق قربات	yunfiqu qurubāt
إنها قربة لهم	innahā qurbatul lahum
سيدخلهم الله	sayudkhiluhumullāh
السابقون الأولون	as-sābiqụnal-awwalụn
الأعراب منافقون	al-a’rābi munāfiqụn
المدينة مردوا	al-madīnati maradụ
لا تعلمهم	lā ta’lamuhum
نحن نعلمهم	naḥnu na’lamuhum
سنعذبهم مرتين	sanu’ażżibuhum marratain
خلطوا عملا	khalaṭụ ‘amalā
صلاتك سكن لهم	ṣalātaka sakanul lahum
ويأخذ الصدقات	wa ya`khużuṣ-ṣadaqāt
اعملوا فسيرى	i’malụ fa sayarā
وستردون إلى	wa saturaddụna ilā
إما يعذبهم	immā yu’ażżibuhum
ضرارا وكفرا	ḍirāraw wa kufrā
أردنا إلا الحسنى	aradnā illal-ḥusnā
إنهم لكاذبون	innahum lakāżibụn
تقم فيه أبدا	taqum fīhi abadā
لمسجد أسس	lamasjidun ussis
رجال يحبون	rijāluy yuḥibbụn
يحب المطهرين	yuḥibbul-muṭṭahhirīn
أسس بنيانه	assasa bun-yānah
يزال بنيانهم	yazālu bun-yānuhum
الله اشترى	allāhasytarā
حقا في التوراة	ḥaqqan fit-taurāh
بايعتم به	bāya’tum bih
التائبون العابدون	attā`ibụnal-‘ābidụn
يستغفروا للمشركين	yastagfirụ lil-musyrikīn
كان استغفار إبراهيم	kānastigfāru ibrāhīm
فلما تبين له	fa lammā tabayyan
لأواه حليم	la`awwāhun ḥalīm
ليضل قوما	liyuḍilla qaumā
ساعة العسرة	sā’atil-‘usrah
رحبت وضاقت	raḥubat wa ḍāqat
ليتوبوا	liyatụbụ
مع الصادقين	ma’aṣ-ṣādiqīn
لأهل المدينة	li`ahlil-madīnah
يطئون موطئا	yaṭa`ụna mauṭi`ā
يضيع أجر	yuḍī’u ajr
نفقة صغيرة	nafaqatan ṣagīrah
لينفروا كافة	liyanfirụ kāffah
طائفة ليتفقهوا	ṭā`ifatul liyatafaqqahụ
مع المتقين	ma’al-muttaqīn
أنزلت سورة	unzilat sụrah
فزادتهم إيمانا	fa zādat-hum īmānā
فزادتهم رجسا	fa zādat-hum rijsā
عام مرة أو مرتين	‘āmim marratan au marratain
أنزلت سورة نظر	unzilat sụratun naẓar
ثم انصرفوا	ṡummanṣarafụ
قوم لا يفقهون	qaumul lā yafqahụn
عنتم حريص	‘anittum ḥarīṣ
فقل حسبي	fa qul ḥasbī
عليه توكلت	‘alaihi tawakkalt
للناس عجبا	lin-nāsi ‘ajabā
لساحر مبين	lasāḥirum mubīn
العرش يدبر الأمر	al-‘arsyi yudabbirul-amr
شفيع إلا	syafī’in illā
ربكم فاعبدوه	rabbukum fa’budụh
أفلا تذكرون	a fa lā tażakkarụn
مرجعكم جميعا	ilaihi marji’ukum jamī’ā
يعيده ليجزي	yu’īduhụ liyajzī
شراب من حميم	syarābum min ḥamīm
الشمس ضياء	asy-syamsa ḍiyā`
إلا بالحق	illā bil-ḥaqq
يفصل الآيات	yufaṣṣilul-āyāt
إن في اختلاف	inna fikhtilāf
لقاءنا ورضوا	liqā`ana wa raḍụ
أولئك مأواهم	ulā`ika ma`wāhum
وعملوا الصالحات	wa ‘amiluṣ-ṣāliḥāt
تحتهم الأنهار	taḥtihimul-an-hār
فيها سلام	fīhā salām
وآخر دعواهم	wa ākhiru da’wāhum
الشر استعجالهم	asy-syarrasti’jālahum
فنذر الذين	fa nażarullażīn
دعانا لجنبه	da’ānā lijambih
ضر مسه	ḍurrim massah
زين للمسرفين	zuyyina lil-musrifīn
ظلموا وجاءتهم	ẓalamụ wa jā`at-hum
لننظر كيف	linanẓura kaif
لقاءنا ائت	liqā`ana`t
من تلقاء نفسي	min tilqā`i nafsī
أتبع إلا	attabi’u illā
عصيت ربي	‘aṣaitu rabbī
لبثت فيكم	labiṡtu fīkum
يفلح المجرمون	yufliḥul-mujrimụn
هؤلاء شفعاؤنا	hā`ulā`i syufa’ā`unā
قل أتنبئون	qul a tunabbi`ụn
واحدة فاختلفوا	wāḥidatan fakhtalafụ
لقضي بينهم	laquḍiya bainahum
لولا أنزل	lau lā unzil
إنما الغيب	innamal-gaib
من المنتظرين	minal-muntaẓirīn
أذقنا الناس	ażaqnan-nās
أسرع مكرا	asra’u makrā
رسلنا يكتبون	rusulana yaktubụn
البر والبحر	al-barri wal-baḥr
كنتم في الفلك	kuntum fil-fulk
بريح طيبة	birīḥin ṭayyibah
لئن أنجيتنا	la`in anjaitanā
فلما أنجاهم	fa lammā anjāhum
إنما بغيكم	innamā bagyukum
فاختلط به	fakhtalaṭa bih
وازينت وظن	wazzayyanat wa ẓann
لقوم يتفكرون	liqaumiy yatafakkarụn
دار السلام	dāris-salām
أحسنوا الحسنى	aḥsanul-ḥusnā
قتر ولا ذلة	qataruw wa lā żillah
بمثلها وترهقهم ذلة	bimiṡlihā wa tar-haquhum żillah
ما لهم من الله من عاصم	mā lahum minallāhi min ‘āṣim
كأنما أغشيت	ka`annamā ugsyiyat
أنتم وشركاؤكم	antum wa syurakā`ukum
إيانا تعبدون	iyyānā ta’budụn
شهيدا بيننا	syahīdam bainanā
أسلفت وردوا	aslafat wa ruddū
يملك السمع والأبصار	yamlikus-sam’a wal-abṣār
فسيقولون الله	fa sayaqụlụnallāh
فقل أفلا تتقون	fa qul a fa lā tattaqụn
فذلكم الله ربكم الحق	fa żālikumullāhu rabbukumul-ḥaqq
إلا الضلال فأنى	illaḍ-ḍalālu fa annā
فسقوا أنهم	fasaqū annahum
يبدأ الخلق	yabda`ul-khalq
من شركائكم	min syurakā`ikum
يهدي للحق	yahdī lil-ḥaqq
يتبع أمن لا	yuttaba’a am mal lā
فما لكم	fa mā lakum
كيف تحكمون	kaifa taḥkumụn
إلا ظنا	illā ẓannā
الحق شيئا	al-ḥaqqi syai`ā
يديه وتفصيل	yadaihi wa tafṣīl
أم يقولون افتراه	am yaqụlụnaftarāh
من استطعتم	manistaṭa’tum
يحيطوا بعلمه	yuḥīṭụ bi’ilmih
عاقبة الظالمين	‘āqibatuẓ-ẓālimīn
أنفسهم يظلمون	anfusahum yaẓlimụn
النهار يتعارفون	an-nahāri yata’ārafụn
قد خسر	qad khasir
نعدهم أو نتوفينك	na’iduhum au natawaffayannak
ولكل أمة رسول	wa likulli ummatir rasụl
قضي بينهم بالقسط	quḍiya bainahum bil-qisṭ
متى هذا الوعد	matā hāżal-wa’d
ضرا ولا نفعا	ḍarraw wa lā naf’ā
لكل أمة أجل	likulli ummatin ajal
ساعة ولا يستقدمون	sā’ataw wa lā yastaqdimụn
بياتا أو نهارا 	bayātan au nahārā 
وقع آمنتم	waqa’a āmantum
به تستعجلون	bihī tasta’jilụn
عذاب الخلد	‘ażābal-khuld
هل تجزون	hal tujzaun
ويستنبئونك أحق هو	wa yastambi`ụnaka aḥaqqun hụ
إي وربي	ī wa rabbī
بمعجزين	bimu’jizīn
لافتدت به	laftadat bih
وأسروا الندامة	wa asarrun-nadāmah
وقضي بينهم	wa quḍiya bainahum
ولكن أكثرهم	wa lākinna akṡarahum
ربكم وشفاء	rabbikum wa syifā`
فبذلك فليفرحوا	fa biżālika falyafraḥụ
حراما وحلالا	ḥarāmaw wa halālā
آلله أذن لكم	āllāhu ażina lakum
الذين يفترون	allażīna yaftarụn
شهودا إذ تفيضون	syuhụdan iż tufīḍụn
وما يعزب عن	wa mā ya’zubu ‘an
كانوا يتقون	kānụ yattaqụn
لهم البشرى	lahumul-busyr
تبديل لكلمات	tabdīla likalimāt
يحزنك قولهم	yaḥzungka qauluhum
العزة لله جميعا	al-‘izzata lillāhi jamī’ā
يدعون من دون	yad’ụna min dụn
إن يتبعون	iy yattabi’ụn
الليل لتسكنوا	al-laila litaskunụ
النهار مبصرا	an-nahāra mubṣirā
لقوم يسمعون	liqaumiy yasma’ụn
ولدا سبحانه	waladan sub-ḥānah
هو الغني	huwal-ganiyy
سلطان بهذا	sulṭānim bihāżā
أتقولون على	a taqụlụna ‘alā
إن الذين يفترون	innallażīna yaftarụn
نذيقهم العذاب	nużīquhumul-‘ażāb
نبأ نوح	naba`a nụḥ
غمة ثم اقضوا	gummatan ṡummaqḍū
فما سألتكم	fa mā sa`altukum
وأمرت أن أكون	wa umirtu an akụn
فكذبوه فنجيناه	fa każżabụhu fa najjaināh
عاقبة المنذرين	‘āqibatul-munżarīn
ثم بعثنا	ṡumma ba’aṡnā
قلوب المعتدين	qulụbil-mu’tadīn
بآياتنا فاستكبروا	bi`āyātinā fastakbarụ
لسحر مبين	lasiḥrum mubīn
أتقولون للحق	a taqụlụna lil-ḥaqq
أسحر هذا	a siḥrun hāżā
يفلح الساحرون	yufliḥus-sāḥirụn
أجئتنا لتلفتنا	a ji`tanā litalfitanā
لكما بمؤمنين	lakumā bimu`minīn
فرعون ائتوني	fir’aunu`tụnī
جاء السحرة	jā`as-saḥarah
جئتم به السحر	ji`tum bihis-siḥr
الله سيبطله	allāha sayubṭiluh
عمل المفسدين	‘amalal-mufsidīn
يحق الله الحق	yuḥiqqullāhul-ḥaqq
ذرية من قومه	żurriyyatum ming qaumih
لعال في الأرض	la’ālin fil-arḍ
لمن المسرفين	laminal-musrifīn
فعليه توكلوا	fa ‘alaihi tawakkalū
توكلنا	tawakkalnā
تجعلنا فتنة	rabbanā lā taj’alnā fitnatal lil-qaumiẓ-ẓālimīn
ونجنا برحمتك	wa najjinā biraḥmatika minal-qaumil-kāfirīn
بمصر بيوتا	bimiṣra buyụtā
وملأه زينة وأموالا	wa mala`ahụ zīnataw wa amwālā
ربنا ليضلوا	rabbanā liyuḍillụ
ربنا اطمس	rabbanaṭmis
أجيبت دعوتكما	ujībad da’watukumā
وجنوده بغيا	wa junụduhụ bagyā
أدركه الغرق	adrakahul-garaq
وقد عصيت	wa qad ‘aṣait
ننجيك ببدنك	nunajjīka bibadanik
آياتنا لغافلون	āyātinā lagāfilụn
مبوأ صدق	mubawwa`a ṣidq
فما اختلفوا	famakhtalafụ
يقضي بينهم	yaqḍī bainahum
كنت في شك	kunta fī syakk
من الممترين	minal-mumtarīn
من الخاسرين	minal-khāsirīn
حقت عليهم كلمت	ḥaqqat ‘alaihim kalimat
يروا العذاب الأليم	yarawul-‘ażābal-alīm
قوم يونس	qauma yụnus
عذاب الخزي	‘ażābal-khizy
كلهم جميعا	kulluhum jamī’ā
أفأنت تكره	a fa anta tukrih
لنفس أن	linafsin an
ويجعل الرجس	wa yaj’alur-rijs
قل انظروا	qulinẓurụ
تغني الآيات	tugnil-āyāt
مثل أيام	miṡla ayyām
قل فانتظروا	qul fantaẓirū
ننجي رسلنا	nunajjī rusulanā
ننج المؤمنين	nunjil-mu`minīn
يتوفاكم وأمرت	yatawaffākum wa umirt
للدين حنيفا	lid-dīni ḥanīfā
ينفعك ولا يضرك	yanfa’uka wa lā yaḍurruk
فإن فعلت فإنك	fa in fa’alta fa innak
بضر فلا كاشف	biḍurrin fa lā kāsyif
راد لفضله	rādda lifaḍlih
يصيب به	yuṣību bih
جاءكم الحق	jā`akumul-ḥaqq
يهتدي لنفسه	yahtadī linafsih
فإنما يضل	fa innamā yaḍill
عليكم بوكيل	‘alaikum biwakīl
واصبر حتى	waṣbir ḥattā
خير الحاكمين	khairul-ḥākimīn
كتاب أحكمت آياته	kitābun uḥkimat āyātuh
ألا تعبدوا	allā ta’budū
نذير وبشير	nażīruw wa basyīr
متاعا حسنا	matā’an ḥasanā
يوم كبير	yauming kabīr
مرجعكم	marji’ukum
يثنون صدورهم	yaṡnụna ṣudụrahum
يستغشون ثيابهم	yastagsyụna ṡiyābahum
مستقرها ومستودعها	mustaqarrahā wa mustauda’ahā
كتاب مبين	kitābim mubīn
الماء ليبلوكم	al-mā`i liyabluwakum
إنكم مبعوثون	innakum mab’ụṡụn
معدودة ليقولن	ma’dụdatil layaqụlunn
ليس مصروفا	laisa maṣrụfā
منا رحمة	minnā raḥmah
ليئوس كفور	laya`ụsung kafụr
أذقناه نعماء	ażaqnāhu na’mā`
لفرح فخور	lafariḥun fakhụr
صبروا وعملوا	ṣabarụ wa ‘amilụ
وأجر كبير	wa ajrung kabīr
فلعلك تارك	fa la’allaka tārik
أنت نذير	anta nażīr
مثله مفتريات	miṡlihī muftarayāt
فإلم يستجيبوا	fa il lam yastajībụ
نوف إليهم	nuwaffi ilaihim
وحبط ما صنعوا	wa ḥabiṭa mā ṣana’ụ
ويتلوه شاهد	wa yatlụhu syāhid
فالنار موعده	fan-nāru mau’iduh
الأشهاد هؤلاء	a-asy-hādu hā`ulā`
ألا لعنة	alā la’nah
ويبغونها عوجا	wa yabgụnahā ‘iwajā
هم كافرون	hum kāfirụn
يكونوا معجزين	yakụnụ mu’jizīn
يضاعف لهم	yuḍā’afu lahum
يستطيعون السمع	yastaṭī’ụnas-sam’
خسروا أنفسهم	khasirū anfusahum
هم الأخسرون	humul-akhsarụn
وأخبتوا إلى	wa akhbatū ilā
كالأعمى والأصم	kal-a’mā wal-aṣamm
يستويان مثلا	yastawiyāni maṡalā
يوم أليم	yaumin alīm
أراذلنا بادي الرأي	arāżilunā bādiyar-ra`y
نظنكم كاذبين	naẓunnukum kāżibīn
فعميت عليكم	fa ‘ummiyat ‘alaikum
أنلزمكموها وأنتم	a nulzimukumụhā wa antum
لا أسألكم	lā as`alukum
أنا بطارد	ana biṭārid
ملاقو ربهم	mulāqụ rabbihim
من ينصرني	may yanṣurunī
تزدري أعينكم	tazdarī a’yunukum
في أنفسهم	fī anfusihim
إذا لمن	iżal lamin
جادلتنا فأكثرت	jādaltana fa akṡart
أنتم بمعجزين	antum bimu’jizīn
أردت أن أنصح	arattu an anṣaḥ
فعلي إجرامي	fa ‘alayya ijrāmī
تبتئس بما	tabta`is bimā
واصنع الفلك	waṣna’il-fulk
إنهم مغرقون	innahum mugraqụn
ويصنع الفلك	wa yaṣna’ul-fulk
عليه ملأ	‘alaihi mala`
تسخروا منا	taskharụ minnā
يخزيه ويحل	yukhzīhi wa yaḥill
وفار التنور	wa fārat-tannụr
معه إلا قليل	ma’ahū illā qalīl
موج كالجبال	maujing kal-jibāl
معزل يا	ma’ziliy yā
جبل يعصمني	jabaliy ya’ṣimunī
عاصم اليوم	‘āṣimal-yaum
الموج فكان	al-mauju fa kān
أرض ابلعي ماءك	arḍubla’ī mā`ak
إن ابني من	innabnī min
أحكم الحاكمين	aḥkamul-ḥākimīn
ليس من أهلك	laisa min ahlik
صالح فلا تسألن	ṣāliḥin fa lā tas`aln
أعظك أن تكون	a’iẓuka an takụn
أسألك ما ليس	as`alaka mā lais
وترحمني أكن	wa tar-ḥamnī akun
نوح اهبط بسلام	nụḥuhbiṭ bisalām
وأمم سنمتعهم	wa umamun sanumatti’uhum
أنباء الغيب	ambā`il-gaib
تعلمها أنت	ta’lamuhā ant
فاصبر	faṣbir
العاقبة للمتقين	al-‘āqibata lil-muttaqīn
عاد أخاهم	‘ādin akhāhum
قوم اعبدوا	qaumi’budụ
إلا مفترون	illā muftarụn
أسألكم عليه	as`alukum ‘alaih
الذي فطرني	‘alallażī faṭaranī
تتولوا مجرمين	tatawallau mujrimīn
جئتنا ببينة	ji`tanā bibayyinah
إلا اعتراك بعض	illa’tarāka ba’ḍ
واشهدوا أني بريء	wasy-hadū annī barī`
دونه فكيدوني	dụnihī fa kīdụn
إني توكلت على	innī tawakkaltu ‘alā
آخذ بناصيتها	ākhiżum bināṣiyatihā
على صراط	‘alā ṣirāṭ
فقد أبلغتكم	fa qad ablagtukum
ويستخلف ربي	wa yastakhlifu rabbī
تضرونه شيئا	taḍurrụnahụ syai`ā
شيء حفيظ	syai`in ḥafīẓ
أمرنا نجينا هودا	amrunā najjainā hụdā
عذاب غليظ	‘ażābin galīẓ
واتبعوا أمر	wattaba’ū amr
الدنيا لعنة	ad-dun-yā la’nah
عادا كفروا	‘ādang kafarụ
بعدا لعاد	bu’dal li’ād
أخاهم صالحا	akhāhum ṣāliḥā
واستعمركم فيها	wasta’marakum fīhā
قريب مجيب	qarībum mujīb
آباؤنا وإننا	ābā`unā wa innanā
أرأيتم إن	a ra`aitum in
فمن ينصرني	fa may yanṣurunī
غير تخسير	gaira takhsīr
تمسوها بسوء	tamassụhā bisū`
داركم ثلاثة أيام	dārikum ṡalāṡata ayyām
وعد غير مكذوب	wa’dun gairu makżụb
نجينا صالحا	najjainā ṣāliḥā
القوي العزيز	al-qawiyyul-‘azīz
ظلموا الصيحة	ẓalamuṣ-ṣaiḥah
يغنوا فيها	yagnau fīhā
ثمود كفروا	ṡamụda kafarụ
بعدا لثمود	bu’dal liṡamụd
بالبشرى قالوا سلاما	bil-busyrā qālụ salāmā
جاء بعجل حنيذ	jā`a bi’ijlin ḥanīż
قوم لوط	qaumi lụṭ
فضحكت فبشرناها	fa ḍaḥikat fa basysyarnāhā
ويلتى أألد	wailatā a alid
وأنا عجوز	wa ana ‘ajụz
لشيء عجيب	lasyai`un ‘ajīb
قالوا أتعجبين	qālū a ta’jabīn
حميد مجيد	ḥamīdum majīd
الروع وجاءته	ar-rau’u wa jā`at-h
لحليم أواه منيب	laḥalīmun awwāhum munīb
إبراهيم أعرض	ibrāhīmu a’riḍ
جاء أمر ربك	jā`a amru rabbik
غير مردود	gairu mardụd
وضاق بهم ذرعا	wa ḍāqa bihim żar’ā
قومه يهرعون	qaumuhụ yuhra’ụn
يعملون السيئات	ya’malụnas-sayyi`āt
هؤلاء بناتي	hā`ulā`i banatī
رجل رشيد	rajulur rasyīd
علمت ما	‘alimta mā
لتعلم ما نريد	lata’lamu mā nurīd
آوي إلى ركن	āwī ilā rukn
بأهلك بقطع	bi`ahlika biqiṭ’
مصيبها ما أصابهم	muṣībuhā mā aṣābahum
موعدهم الصبح	mau’idahumuṣ-ṣub-h
الصبح بقريب	aṣ-ṣub-ḥu biqarīb
سجيل منضود	sijjīlim manḍụd
مسومة عند ربك	musawwamatan ‘inda rabbik
الظالمين ببعيد	aẓ-ẓālimīna biba’īd
أخاهم شعيبا	akhāhum syu’aibā
تنقصوا المكيال	tangquṣul-mikyāl
أوفوا المكيال	auful-mikyāl
بقيت الله	baqiyyatullāh
عليكم بحفيظ	‘alaikum biḥafīẓ
شعيب أصلاتك	syu’aibu a ṣalātuk
الحليم الرشيد	al-ḥalīmur-rasyīd
ما أنهاكم عنه	mā an-hākum ‘an-h
الإصلاح ما استطعت	al-iṣlāḥa mastaṭa’t
وما توفيقي	wa mā taufīqī
وإليه أنيب	wa ilaihi unīb
يجرمنكم شقاقي	yajrimannakum syiqāqī
ببعيد	biba’īd
واستغفروا	wastagfirụ
رحيم ودود	raḥīmuw wadụd
فينا ضعيفا	fīnā ḍa’īfā
رهطك لرجمناك	rahṭuka larajamnāk
أرهطي أعز	a rahṭī a’azz
وراءكم ظهريا	warā`akum ẓihriyyā
تعملون محيط	ta’malụna muḥīṭ
قوم اعملوا	qaumi’malụ
يأتيه عذاب	ya`tīhi ‘ażāb
معكم رقيب	ma’akum raqīb
نجينا شعيبا	najjainā syu’aibā
ظلموا الصيحة	ẓalamuṣ-ṣaiḥah
يغنوا فيها	yagnau fīhā
بعدا لمدين	bu’dal limadyan
وسلطان مبين	wa sulṭānim mubīn
وملئه فاتبعوا	wa mala`ihī fattaba’ū
فرعون برشيد	fir’auna birasyīd
فأوردهم النار	fa auradahumun-nār
الورد المورود	al-wirdul-maurụd
لعنة ويوم	la’nataw wa yaum
الرفد المرفود	ar-rifdul-marfụd
قائم وحصيد	qā`imuw wa ḥaṣīd
آلهتهم التي	ālihatuhumullatī
غير تتبيب	gaira tatbīb
أخذ القرى	akhażal-qurā
أخذه أليم	akhżahū alīm
لمن خاف	liman khāf
يوم مشهود	yaumum masy-hụd
لأجل معدود	li`ajalim ma’dụd
إلا بإذنه	illā bi`iżnih
شقي وسعيد	syaqiyyuw wa sa’īd
زفير وشهيق	zafīruw wa syahīq
دامت السماوات	dāmatis-samāwāt
فعال لما	fa”ālul limā
سعدوا ففي	su’idụ fa fī
غير مجذوذ	gaira majżụż
يعبد هؤلاء	ya’budu hā`ulā`
يعبد آباؤهم	ya’budu ābā`uhum
غير منقوص	gaira mangqụṣ
فاختلف فيه	fakhtulifa fīh
كلمة سبقت	kalimatun sabaqat
منه مريب	min-hu murīb
ربك أعمالهم	rabbuka a’mālahum
معك ولا تطغوا	ma’aka wa lā taṭgau
ظلموا فتمسكم	ẓalamụ fa tamassakum
طرفي النهار	ṭarafayin-nahār
يذهبن السيئات	yuż-hibnas-sayyi`āt
ذكرى للذاكرين	żikrā liż-żākirīn
يضيع أجر	yuḍī’u ajr
أولو بقية ينهون	ulụ baqiyyatiy yan-haun
ظلموا ما أترفوا	ẓalamụ mā utrifụ
ليهلك القرى	liyuhlikal-qurā
يزالون مختلفين	yazālụna mukhtalifīn
رحم ربك	raḥima rabbuk
ولذلك خلقهم	wa liżālika khalaqahum
ربك لأملأن	rabbika la`amla`ann
فؤادك وجاءك	fu`ādaka wa jā`ak
يؤمنون اعملوا	yu`minụna’malụ
إنا عاملون	innā ‘āmilụn
وانتظروا	wantaẓirụ
إنا منتظرون	innā muntaẓirụn
يرجع الأمر 	yurja’ul-amr
ربك بغافل	rabbuka bigāfil
تلك آيات	tilka āyāt
قرآنا عربيا	qur`ānan ‘arabiyyā
لمن الغافلين	laminal-gāfilīn
يوسف لأبيه	iż qāla yụsufu li`abīhi yā abati innī ra`aitu aḥada ‘asyara kaukabaw wasy-syamsa wal-qamara ra`aituhum lī sājidīn
تقصص رؤياك	taqṣuṣ ru`yāk
الشيطان للإنسان	asy-syaiṭāna lil-insān
تأويل الأحاديث	ta`wīlil-aḥādīṡ
آيات للسائلين	āyātul lis-sā`ilīn
ونحن عصبة	wa naḥnu ‘uṣbah
أبانا لفي	abānā lafī
أو اطرحوه أرضا	awiṭraḥụhu arḍā
غيابت الجب يلتقطه	gayābatil-jubbi yaltaqiṭ-h
لك لا تأمنا	laka lā ta`mann
غدا يرتع	gaday yarta’
يأكله الذئب	ya`kulahuż-żi`b
الذئب ونحن	aż-żi`bu wa naḥn
به وأجمعوا	bihī wa ajma’ū
لتنبئنهم بأمرهم	latunabbi`annahum bi`amrihim
عشاء يبكون	‘isyā`ay yabkụn
ذهبنا نستبق	żahabnā nastabiq
كنا صادقين	kunnā ṣādiqīn
قميصه بدم	qamīṣihī bidam
بل سولت	bal sawwalat
فصبر جميل	fa ṣabrun jamīl
سيارة فأرسلوا	sayyāratun fa arsalụ
بشرى هذا غلام	busyrā hāżā gulām
وأسروه بضاعة	wa asarrụhu biḍā’ah
دراهم معدودة 	darāhima ma’dụdah
من الزاهدين	minaz-zāhidīn
أكرمي مثواه	akrimī maṡwāh
تأويل الأحاديث	ta`wīlil-aḥādīṡ
ولكن أكثر	wa lākinna akṡar
بلغ أشده	balaga asyuddah
وغلقت الأبواب	wa gallaqatil-abwāb
أحسن مثواي	aḥsana maṡwāy
ولقد همت	wa laqad hammat
رأى برهان	ra`ā bur-hān
كذلك لنصرف	każālika linaṣrif
عبادنا المخلصين	‘ibādinal-mukhlaṣīn
واستبقا الباب	wastabaqal-bāb
بأهلك سوءا	bi`ahlika sū`ā
هي راودتني	hiya rāwadatnī
قبل فصدقت	qubulin fa ṣadaqat
 دبر فكذبت	duburin fa każabat
رأى قميصه	ra`ā qamīṣah
كيدكن عظيم	kaidakunna ‘aẓīm
واستغفري لذنبك	wastagfirī liżambik
المدينة امرأت	al-madīnatimra`at
شغفها حبا	syagafahā ḥubbā
إنا لنراها في	innā lanarāhā fī
لهن متكأ وآتت	lahunna muttaka`aw wa ātat
وقطعن أيديهن	wa qaṭṭa’na aidiyahunn
ملك كريم	malakung karīm
فذلكن الذي	fa żālikunnallażī
نفسه فاستعصم	nafsihī fasta’ṣam
آمره ليسجنن	āmuruhụ layusjanann
رب السجن أحب	rabbis-sijnu aḥabb
كيدهن أصب	kaidahunna aṣb
فصرف عنه	fa ṣarafa ‘an-h
الآيات ليسجننه	al-āyāti layasjununnah
السجن فتيان	as-sijna fatayān
أراني أعصر خمرا	arānī a’ṣiru khamrā
رأسي خبزا	ra`sī khubzā
نبئنا بتأويله	nabbi`nā bita`wīlih
نبأتكما بتأويله	nabba`tukumā bita`wīlih
مما علمني	mimmā ‘allamanī
تركت ملة	innī taraktu millah
ملة آبائي	millata ābā`ī ibrāhīma wa is-ḥāqa wa ya’qụb
أن نشرك بالله	an nusyrika billāh
الناس ولكن	an-nāsi wa lākin
السجن أأرباب 	as-sijni a arbābā
أسماء سميتموها	asmā`an sammaitumụhā
الحكم إلا	al-ḥukmu illā
أمر ألا تعبدوا	amara allā ta’budū
ذلك الدين	żālikad-dīn
السجن أما	as-sijni ammā
فيصلب فتأكل	fa yuṣlabu fa ta`kul
فيه تستفتيان	fīhi tastaftiyān
فأنساه الشيطان	fa ansāhusy-syaiṭān
سبع بقرات	sab’a baqarāt
الملأ أفتوني	al-mala`u aftụnī
أضغاث أحلام	aḍgāṡu aḥlām
بتأويل الأحلام	bita`wīlil-aḥlām
وادكر بعد	waddakara ba’d
أيها الصديق	ayyuhaṣ-ṣiddīq
سنين دأبا	sinīna da`abā
حصدتم فذروه	ḥaṣattum fa żarụh
سبع شداد	sab’un syidād
فيه يغاث	fīhi yugāṡ
الملك ائتوني	al-maliku`tụnī
بال النسوة اللاتي	bālun-niswatillātī
ربي بكيدهن	rabbī bikaidihinn
خطبكن إذ راودتن	khaṭbukunna iż rāwattunn
قلن حاش	qulna ḥāsy
الآن حصحص	al-āna ḥaṣ-ḥaṣ
أخنه بالغيب	akhun-hu bil-gaib
أبرئ نفسي	ubarri`u nafsī
النفس لأمارة	an-nafsa la`ammārah
ائتوني به أستخلصه	u`tụnī bihī astakhliṣ-h
مكين أمين	makīnun amīn
خزائن الأرض	khazā`inil-arḍ
إني حفيظ	innī ḥafīẓ
يتبوأ منها	yatabawwa`u min-hā
نصيب برحمتنا	nuṣību biraḥmatinā
ولأجر الآخرة	wa la`ajrul-ākhirah
يوسف فدخلوا	yụsufa fa dakhalụ
قال ائتوني بأخ لكم	qāla`tụnī bi`akhil lakum
ألا ترون أني	alā tarauna annī
تأتوني به	ta`tụnī bih
سنراود عنه	sanurāwidu ‘an-h
إذا انقلبوا	iżangqalabū
أخانا نكتل	akhānā naktal
كما أمنتكم	kamā amintukum
خير حافظا	khairun ḥāfiẓā
وجدوا بضاعتهم	wajadụ biḍā’atahum
أبانا ما نبغي	abānā mā nabgī
ونزداد كيل بعير	wa nazdādu kaila ba’īr
كيل يسير	kailuy yasīr
تؤتون موثقا	tu`tụni mauṡiqā
نقول وكيل	naqụlu wakīl
أبواب متفرقة	abwābim mutafarriqah
أغني عنكم	ugnī ‘angkum
إن الحكم	inil-ḥukm
فليتوكل المتوكلون	falyatawakkalil-mutawakkilụn
أمرهم أبوهم	amarahum abụhum
يعقوب قضاها	ya’qụba qaḍāhā
لما علمناه	limā ‘allamnāh
أنا أخوك فلا	ana akhụka fa lā
جعل السقاية	ja’alas-siqāyah
ماذا تفقدون	māżā tafqidụn
نفقد صواع	nafqidu ṣuwā’
جئنا لنفسد	ji`nā linufsid
كنتم كاذبين	kuntum kāżibīn
جزاؤه من وجد	jazā`uhụ maw wujid
كذلك نجزي	każālika najzī
فبدأ بأوعيتهم	fa bada`a bi`au’iyatihim
كدنا ليوسف	kidnā liyụsuf
ليأخذ أخاه	liya`khuża akhāh
نرفع درجات	narfa’u darajāt
فوق كل ذي	fauqa kulli żī
سرق أخ	saraqa akh
فأسرها يوسف	fa asarrahā yụsuf
شر مكانا	syarrum makānā
بما تصفون	bimā taṣifụn
شيخا كبيرا	syaikhang kabīrā
إنا نراك من	innā narāka min
وجدنا متاعنا	wajadnā matā’anā
خلصوا نجيا	khalaṣụ najiyyā
أخذ عليكم موثقا	akhaża ‘alaikum mauṡiqā
خير الحاكمين	khairul-ḥākimīn
إن ابنك سرق	innabnaka saraq
للغيب حافظين	lil-gaibi ḥāfiẓīn
واسأل القرية	was`alil-qaryah
وإنا لصادقون	wa innā laṣādiqụn
بل سولت	bal sawwalat
فصبر جميل	fa ṣabrun jamīl
أن يأتيني	ay ya`tiyanī
وابيضت عيناه	wabyaḍḍat ‘aināh
تفتأ تذكر	tafta`u tażkur
أشكو بثي	asykụ baṡṡī
بني اذهبوا فتحسسوا	baniyyaż-habụ fa taḥassasụ
لا ييأس	lā yai`as
مزجاة فأوف لنا	muzjātin fa aufi lanā
يجزي المتصدقين	yajzil-mutaṣaddiqīn
فعلتم بيوسف	fa’altum biyụsuf
أإنك لأنت يوسف	a innaka la`anta yụsuf
هذا أخي قد	hāżā akhī qad
يتق ويصبر	yattaqi wa yaṣbir
كنا لخاطئين	kunnā lakhāṭi`īn
لا تثريب	lā taṡrīb
أرحم الراحمين	ar-ḥamur-rāḥimīn
اذهبوا بقميصي	iż-habụ biqamīṣī
وأتوني بأهلكم	wa`tụnī bi`ahlikum
فصلت العير	faṣalatil-‘īr
ضلالك القديم	ḍalālikal-qadīm
البشير ألقاه	al-basyīru alqāh
إني أعلم	innī a’lam
يا أبانا استغفر لنا	yā abānastagfir lanā
 سوف أستغفر	saufa astagfir
قال ادخلوا مصر	qāladkhulụ miṣr
ورفع أبويه	wa rafa’a abawaih
تأويل رؤياي	ta`wīlu ru`yāyā
بين إخوتي	baina ikhwatī
لطيف لما	laṭīful limā
تأويل الأحاديث	ta`wīlil-aḥādīṡ
أنت وليي	anta waliyyī
ألحقني بالصالحين	al-ḥiqnī biṣ-ṣāliḥīn
أنباء الغيب	ambā`il-gaib
أجمعوا أمرهم	ajma’ū amrahum
حرصت بمؤمنين	ḥaraṣta bimu`minīn
تسألهم عليه	tas`aluhum ‘alaih
ذكر للعالمين	żikrul lil-‘ālamīn
عنها معرضون	‘an-hā mu’riḍụn
يؤمن أكثرهم	yu`minu akṡaruhum
تأتيهم غاشية	ta`tiyahum gāsyiyah
سبيلي أدعو	sabīlī ad’ū
أنا من المشركين	ana minal-musyrikīn
رجالا نوحي	rijālan nụḥī
أفلم يسيروا	a fa lam yasīrụ
للذين اتقوا	lillażīnattaqau
إذا استيأس الرسل	iżastai`asar-rusul
يرد بأسنا	yuraddu ba`sunā
قصصهم عبرة	qaṣaṣihim ‘ibrah
حديثا يفترى	ḥadīṡay yuftarā
آيات الكتاب	āyātul-kitāb
ربك الحق	rabbikal-ḥaqq
بغير عمد	bigairi ‘amad
لأجل مسمى	li`ajalim musammā
لعلكم بلقاء	la’allakum biliqā`
رواسي وأنهارا	rawāsiya wa an-hārā
زوجين اثنين	zaujainiṡnain
صنوان يسقى	ṣinwāniy yusqā
أإذا كنا ترابا أإنا	a iżā kunnā turāban a innā
وأولئك الأغلال	wa ulā`ikal-aglāl
قبلهم المثلات	qablihimul-maṡulāt
لذو مغفرة	lażụ magfirah
لشديد العقاب	lasyadīdul-‘iqāb
قوم هاد	qaumin hād
تغيض الأرحام	tagīḍul-ar-ḥām
عنده بمقدار	‘indahụ bimiqdār
الكبير المتعال	al-kabīrul-muta’āl
بالليل وسارب	bil-laili wa sārib
له معقبات من	lahụ mu’aqqibātum min
حتى يغيروا	ḥattā yugayyirụ
سوءا فلا مرد	sū`an fa lā maradd
من وال	miw wāl
وطمعا وينشئ	wa ṭama’aw wa yunsyi`
ويسبح الرعد	wa yusabbiḥur-ra’d
ويرسل الصواعق	wa yursiluṣ-ṣawā’iq
شديد المحال	syadīdul miḥāl
دعوة الحق	da’watul-ḥaqq
كباسط كفيه	kabāsiṭi kaffaih
دعاء الكافرين	du’ā`ul-kāfirīn
بالغدو والآصال	bil-guduwwi wal-āṣāl
نفعا ولا ضرا	naf’aw wa lā ḍarrā
تستوي الظلمات	tastawiẓ-ẓulumāt
كخلقه فتشابه	kakhalqihī fa tasyābah
الواحد القهار	al-wāḥidul-qahhār
أودية بقدرها	audiyatum biqadarihā
النار ابتغاء حلية	an-nāribtigā`a ḥilyah
الحق والباطل	al-ḥaqqa wal-bāṭil
الزبد فيذهب	az-zabadu fa yaż-hab
الناس فيمكث	an-nāsa fa yamkuṡ
يضرب الله الأمثال	yaḍribullāhul-amṡāl
للذين استجابوا لربهم	lillażīnastajābụ lirabbihim
لافتدوا به	laftadau bih
ومأواهم جهنم	wa ma`wāhum jahannam
وبئس المهاد	wa bi`sal-mihād
كمن هو أعمى	kaman huwa a’mā
إنما يتذكر	innamā yatażakkar
ينقضون الميثاق	yangquḍụnal-mīṡāq
يوصل ويخشون	yụṣala wa yakhsyaun
وعلانية ويدرءون	wa ‘alāniyataw wa yadra`ụn
وذرياتهم والملائكة	wa żurriyyātihim wal-malā`ikah
صبرتم فنعم	ṣabartum fa ni’m
ميثاقه ويقطعون	mīṡāqihī wa yaqṭa’ụn
يشاء ويقدر	yasyā`u wa yaqdir
وفرحوا بالحياة	wa fariḥụ bil-ḥayāh
إلا متاع	illā matā’
لولا أنزل عليه	lau lā unzila ‘alaih
يشاء ويهدي	yasyā`u wa yahdī
وتطمئن قلوبهم	wa taṭma`innu qulụbuhum
تطمئن القلوب	taṭma`innul-qulụb
الصالحات طوبى	aṣ-ṣāliḥāti ṭụbā
أمم لتتلو عليهم	umamul litatluwā ‘alaihim
وإليه متاب	wa ilaihi matāb
قرآنا سيرت	qur`ānan suyyirat
الأمر جميعا	al-amru jamī’ā
أفلم ييأس	a fa lam yai`as
صنعوا قارعة	ṣana’ụ qāri’ah
فكيف كان عقاب	fa kaifa kāna ‘iqāb
أفمن هو قائم	a fa man huwa qā`im
لله شركاء	lillāhi syurakā`
قل سموهم	qul sammụhum
أم تنبئونه	am tunabbi`ụnah
مكرهم وصدوا	makruhum wa ṣuddụ
له من هاد	lahụ min hād
الآخرة أشق	al-ākhirati asyaqq
من واق	miw wāq
وعد المتقون	wu’idal-muttaqụn
دائم وظلها	dā`imuw wa ẓilluhā
الذين اتقوا وعقبى	allażīnattaqaw wa ‘uqbā
ينكر بعضه	yungkiru ba’ḍah
ولا أشرك به	wa lā usyrika bih
أدعو وإليه مآب	ad’ụ wa ilaihi ma`āb
حكما عربيا	ḥukman ‘arabiyyā
بعدما جاءك	ba’da mā jā`ak
أزواجا وذرية	azwājaw wa żurriyyah
يأتي بآية	ya`tiya bi`āyah
أجل كتاب	ajaling kitāb
يشاء ويثبت	yasyā`u wa yuṡbit
أم الكتاب	ummul-kitāb
أو نتوفينك	au natawaffayannak
ننقصها من أطرافها	nangquṣuhā min aṭrāfihā
معقب لحكمه	mu’aqqiba liḥukmih
المكر جميعا	al-makru jamī’ā
تكسب كل نفس	taksibu kullu nafs
وسيعلم الكفار	wa saya’lamul-kuffār
لست مرسلا	lasta mursalā
علم الكتاب	‘ilmul-kitāb
العزيز الحميد	al-‘azīzil-ḥamīd
عذاب شديد	‘ażābin syadīd
ويبغونها عوجا	wa yabgụnahā ‘iwajā
ليبين لهم	liyubayyina lahum
ويهدي من يشاء	wa yahdī may yasyā`
بآياتنا أن أخرج	bi`āyātinā an akhrij
صبار شكور	ṣabbārin syakụr
ويذبحون أبناءكم	wa yużabbiḥụna abnā`akum
لئن شكرتم لأزيدنكم	la`in syakartum la`azīdannakum
لغني حميد	laganiyyun ḥamīd
وعاد وثمود	wa ‘ādiw wa ṡamụd
من بعدهم	mim ba’dihim
لا يعلمهم	lā ya’lamuhum
تدعوننا إليه مريب	tad’ụnanā ilaihi murīb
رسلهم أفي الله	rusuluhum a fillāh
بشر مثلنا	basyarum miṡlunā
آباؤنا فأتونا	ābā`unā fa`tụnā
يمن على	yamunnu ‘alā
أن نأتيكم بسلطان	an na`tiyakum bisulṭān
وقد هدانا سبلنا	wa qad hadānā subulanā
ما آذيتمونا	mā āżaitumụnā
أرضنا أو لتعودن	arḍinā au lata’ụdunn
لنهلكن الظالمين	lanuhlikannaẓ-ẓālimīn
ولنسكننكم الأرض	wa lanuskinannakumul-arḍ
وخاف وعيد	wa khāfa wa’īd
واستفتحوا وخاب	wastaftaḥụ wa khāb
من ورائه جهنم	miw warā`ihī jahannam
يسيغه ويأتيه	yusīguhụ wa ya`tīh
عذاب غليظ	‘ażābun galīẓ
كرماد اشتدت	karamādinisytaddat
الضلال البعيد	aḍ-ḍalālul-ba’īd
والأرض بالحق	wal-arḍa bil-ḥaqq
يشأ يذهبكم ويأت	yasya` yuż-hibkum wa ya`t
الله بعزيز	‘alallāhi bi’azīz
فقال الضعفاء	fa qālaḍ-ḍu’afā`
لو هدانا	lau hadānā
أجزعنا أم صبرنا	ajazi’nā am ṣabarnā
ووعدتكم فأخلفتكم	wa wa’attukum fa akhlaftukum
دعوتكم فاستجبتم	da’autukum fastajabtum
ولوموا أنفسكم	wa lụmū anfusakum
أنتم بمصرخي	antum bimuṣrikhiyy
كفرت بما أشركتمون	kafartu bimā asyraktumụn
الصالحات جنات	aṣ-ṣāliḥāti jannāt
تحيتهم فيها سلام	taḥiyyatuhum fīhā salām
طيبة كشجرة	ṭayyibatang kasyajarah
حين بإذن	ḥīnim bi`iżn
لعلهم يتذكرون	la’allahum yatażakkarụn
خبيثة اجتثت	khabīṡatinijtuṡṡat
بالقول الثابت	bil-qauliṡ-ṡābit
الله الظالمين	allāhuẓ-ẓālimīn
ويفعل الله	wa yaf’alullāh
قومهم دار البوار	qaumahum dāral-bawār
جهنم	jahannam
يصلونها	yaṣlaunahā
وبئس القرار	wa bi`sal-qarār
أندادا ليضلوا	andādal liyuḍillụ
فإن مصيركم	fa inna maṣīrakum
رزقناهم سرا وعلانية	razaqnāhum sirraw wa ‘alāniyah
الفلك لتجري	al-fulka litajrī
وسخر لكم	wasakhkhara lakum
الشمس والقمر دائبين	asy-syamsa wal-qamara dā`ibaīn
لكم الليل	lakumul-lail
ما سألتموه	mā sa`altumụh
لا تحصوها	lā tuḥṣụhā
لظلوم كفار	laẓalụmung kaffār
أن نعبد الأصنام	an na’budal-aṣnām
رب إنهن أضللن 	rabbi innahunna aḍlaln
فمن تبعني	fa man tabi’anī
ومن عصاني فإنك	wa man ‘aṣānī fa innak
بواد غير ذي	biwādin gairi żī
نخفي وما نعلن	nukhfī wa mā nu’lin
وما يخفى على	wa mā yakhfā ‘alā
الكبر إسماعيل	al-kibari ismā’īl
لسميع الدعاء	lasamī’ud-du’ā`
وتقبل دعاء	wa taqabbal du’ā`
يقوم الحساب	yaqụmul-ḥisāb
تحسبن الله غافلا	taḥsabannallāha gāfilā
ليوم تشخص	liyaumin tasykhaṣ
مهطعين مقنعي	muhṭi’īna muqni’ī
وأفئدتهم هواء	wa af`idatuhum hawā`
قريب نجب دعوتك	qarībin nujib da’watak
تكونوا أقسمتم	takụnū aqsamtum
سكنتم في مساكن	sakantum fī masākin
لتزول منه الجبال	litazụla min-hul-jibāl
مخلف وعده	mukhlifa wa’dih
عزيز ذو انتقام	‘azīzun żuntiqām
تبدل الأرض	tubaddalul-arḍ
مقرنين في الأصفاد	muqarranīna fil-aṣfād
قطران وتغشى	qaṭirāniw wa tagsyā
نفس ما كسبت	nafsim mā kasabat
واحد وليذكر	wāḥiduw wa liyażżakkar
وقرآن مبين	wa qur`ānim mubīn
كانوا مسلمين	kānụ muslimīn
ويلههم الأمل	wa yul-hihimul-amal
كتاب معلوم	kitābum ma’lụm
وما يستأخرون	wa mā yasta`khirụn
إنك لمجنون	innaka lamajnụn
ما تأتينا بالملائكة	mā ta`tīnā bil-malā`ikah
إذا منظرين	iżam munẓarīn
له لحافظون	lahụ laḥāfiẓụn
شيع الأولين	syiya’il-awwalīn
كذلك نسلكه	każālika naslukuh
سنة الأولين	sunnatul-awwalīn
فظلوا فيه يعرجون	fa ẓallụ fīhi ya’rujụn
سكرت أبصارنا	sukkirat abṣārunā
بروجا وزيناها	burụjaw wa zayyannāhā
وحفظناها من	wa ḥafiẓnāhā min
من استرق السمع	manistaraqas-sam’
مددناها وألقينا	madadnāhā wa alqainā
معايش ومن لستم	ma’āyisya wa mal lastum
بقدر معلوم	biqadarim ma’lụm
الرياح لواقح	ar-riyāḥa lawāqiḥ
له بخازنين	lahụ bikhāzinīn
ونحن الوارثون	wa naḥnul-wāriṡụn
علمنا المستأخرين	‘alimnal-musta`khirīn
هو يحشرهم	huwa yaḥsyuruhum
من حمإ مسنون	min ḥama`im masnụn
والجان خلقناه	wal-jānna khalaqnāh
حمإ مسنون	ḥama`im masnụn
سويته ونفخت	sawwaituhụ wa nafakht
فسجد الملائكة	fa sajadal-malā`ikah
إلا إبليس	illā iblīs
مع الساجدين	ma’as-sājidīn
ألا تكون مع	allā takụna ma’
أكن لأسجد لبشر	akul li`asjuda libasyar
فإنك رجيم	fa innaka rajīm
عليك اللعنة إلى	‘alaikal-la’nata ilā
يوم يبعثون	yaumi yub’aṡụn
الوقت المعلوم	al-waqtil-ma’lụm
أغويتني لأزينن	agwaitanī la`uzayyinann
منهم المخلصين	min-humul-mukhlaṣīn
من الغاوين	minal-gāwīn
لموعدهم أجمعين	lamau’iduhum ajma’īn
سبعة أبواب	sab’atu abwāb
جزء مقسوم	juz`um maqsụm
جنات وعيون	jannātiw wa ‘uyụn
ادخلوها بسلام	udkhulụhā bisalām
سرر متقابلين	sururim mutaqābilīn
منها بمخرجين	min-hā bimukhrajīn
نبئ عبادي	nabbi` ‘ibādī
العذاب الأليم	al-‘ażābul-alīm
ضيف إبراهيم	ḍaifi ibrāhīm
فقالوا سلاما	fa qālụ salāmā
منكم وجلون	mingkum wajilụn
إنا نبشرك بغلام	innā nubasysyiruka bigulām
قال أبشرتموني	qāla a basysyartumụnī
بشرناك بالحق	qālụ basysyarnāka bil-ḥaqq
إلا الضالون	illaḍ-ḍāllụn
أيها المرسلون	ayyuhal-mursalụn
قوم مجرمين	qaumim mujrimīn
إلا آل لوط	illā āla lụṭ
لمنجوهم أجمعين	lamunajjụhum ajma’īn
إلا امرأته قدرنا	illamra`atahụ qaddarnā
آل لوط المرسلون	āla lụṭinil-mursalụn
قوم منكرون	qaumum mungkarụn
بل جئناك	bal ji`nāk
وأتيناك بالحق	wa ataināka bil-ḥaqq
فأسر بأهلك	fa asri bi`ahlik
مقطوع مصبحين	maqṭụ’um muṣbiḥīn
المدينة يستبشرون	al-madīnati yastabsyirụn
هؤلاء ضيفي	hā`ulā`i ḍaifī
ولا تخزون	wa lā tukhzụn
أولم ننهك	a wa lam nan-hak
هؤلاء بناتي	hā`ulā`i banātī
سكرتهم يعمهون	sakratihim ya’mahụn
فأخذتهم الصيحة	fa akhażat-humuṣ-ṣaiḥah
سافلها وأمطرنا	sāfilahā wa amṭarnā
لآيات للمتوسمين	la`āyātil lil-mutawassimīn
لبسبيل مقيم	labisabīlim muqīm
لآية للمؤمنين	la`āyatal lil-mu`minīn
أصحاب الأيكة	aṣ-ḥābul-aikah
فانتقمنا منهم	fantaqamnā min-hum
لبإمام مبين	labi`imāmim mubīn
الحجر المرسلين	al-ḥijril-mursalīn
وآتيناهم آياتنا	wa ātaināhum āyātinā
بيوتا آمنين	buyụtan āminīn
الصيحة مصبحين	aṣ-ṣaiḥatu muṣbiḥīn
كانوا يكسبون	kānụ yaksibụn
بينهما إلا بالحق	bainahumā illā bil-ḥaqq
فاصفح الصفح	faṣfaḥiṣ-ṣaf-ḥ
الخلاق العليم	al-khallāqul-‘alīm
آتيناك سبعا	ātaināka sab’ā
تمدن عينيك	tamuddanna ‘ainaik
النذير المبين	an-nażīrul-mubīn
على المقتسمين	‘alal-muqtasimīn
القرآن عضين	al-qur`āna ‘iḍīn
فوربك لنسألنهم	fa wa rabbika lanas`alannahum
تؤمر وأعرض	tu`maru wa a’riḍ
كفيناك المستهزئين	kafainākal-mustahzi`īn
إلها آخر	ilāhan ākhar
فسوف يعلمون	fa saufa ya’lamụn
يضيق صدرك	yaḍīqu ṣadruk
فسبح بحمد	fa sabbiḥ biḥamd
يأتيك اليقين	ya`tiyakal-yaqīn
فلا تستعجلوه	fa lā tasta’jilụh
أن أنذروا أنه	an anżirū annah
خصيم مبين	khaṣīmum mubīn
ومنها تأكلون	wa min-hā ta`kulụn
حين تريحون	ḥīna turīḥụn
بشق الأنفس	bisyiqqil-anfus
والبغال والحمير	wal-bigāla wal-ḥamīr
قصد السبيل	qaṣdus-sabīl
لهداكم أجمعين	lahadākum ajma’īn
شجر فيه تسيمون	syajarun fīhi tusīmụn
الزرع والزيتون	az-zar’a waz-zaitụn
مسخرات بأمره	musakhkharātum bi`amrih
مختلفا ألوانه	mukhtalifan alwānuh
لقوم يذكرون	liqaumiy yażżakkarụn
لحما طريا وتستخرجوا	laḥman ṭariyyaw wa tastakhrijụ
الفلك مواخر	al-fulka mawākhir
وأنهارا وسبلا	wa an-hāraw wa subulā
وعلامات	wa ‘alāmāt
بالنجم هم يهتدون	bin-najmi hum yahtadụn
أفمن يخلق	a fa may yakhluq
تعدوا نعمة	ta’uddụ ni’mah
تسرون وما تعلنون	tusirrụna wa mā tu’linụn
يخلقون شيئا	yakhluqụna syai`ā
أموات غير أحياء	amwātun gairu aḥyā`
أيان يبعثون	ayyāna yub’aṡụn
إلهكم إله واحد	ilāhukum ilāhuw wāḥid
منكرة وهم مستكبرون	mungkiratuw wa hum mustakbirụn
يسرون وما يعلنون	yusirrụna wa mā yu’linụn
يحب المستكبرين	yuḥibbul-mustakbirīn
أوزار الذين يضلونهم	auzārillażīna yuḍillụnahum
ساء ما يزرون	sā`a mā yazirụn
السقف من فوقهم	as-saqfu min fauqihim
أين شركائي الذين	aina syurakā`iyallażīn
الخزي اليوم	al-khizyal-yaum
تتوفاهم الملائكة	tatawaffāhumul-malā`ikah
فادخلوا أبواب	fadkhulū abwāb
فلبئس مثوى	fa labi`sa maṡwā
قالوا خيرا	qālụ khairā
الدنيا حسنة	ad-dun-yā ḥasanah
الآخرة خير	al-ākhirati khaīr
ولنعم دار	wa lani’ma dār
عدن يدخلونها تجري	 ‘adniy yadkhulụnahā tajrī
يجزي الله المتقين	yajzillāhul-muttaqīn
تتوفاهم الملائكة طيبين	tatawaffāhumul-malā`ikatu ṭayyibīn
يأتي أمر ربك	ya`tiya amru rabbik
فأصابهم سيئات	fa aṣābahum sayyi`āt
آباؤنا ولا حرمنا	ābā`unā wa lā ḥarramnā
البلاغ المبين	al-balāgul-mubīn
واجتنبوا الطاغوت	wajtanibuṭ-ṭāgụt
عليه الضلالة	‘alaihiḍ-ḍalālah
عاقبة المكذبين	‘āqibatul-mukażżibīn
من ناصرين	min nāṣirīn
جهد أيمانهم	jahda aimānihim
بلى وعدا عليه	balā wa’dan ‘alaih
ليبين لهم الذي	liyubayyina lahumullażī
إذا أردناه أن	iżā aradnāhu an
ظلموا لنبوئنهم	ẓulimụ lanubawwi`annahum
ولأجر الآخرة أكبر	wa la`ajrul-ākhirati akbar
ربهم يتوكلون	rabbihim yatawakkalụn
رجالا نوحي إليهم 	rijālan nụḥī ilaihim
بالبينات والزبر	bil-bayyināti waz-zubur
لتبين للناس	litubayyina lin-nās
مكروا السيئات	makarus-sayyi`āt
أو يأخذهم في تقلبهم	au ya`khużahum fī taqallubihim
أو يأخذهم على تخوف	au ya`khużahum ‘alā takhawwuf
فإن ربكم لرءوف رحيم	fa inna rabbakum lara`ụfur raḥīm
يتفيأ ظلاله	yatafayya`u ẓilāluh
من دابة والملائكة	min dābbatiw wal-malā`ikah
ويفعلون ما يؤمرون	wa yaf’alụna mā yu`marụn
إلهين اثنين	ilāhainiṡnaīn
واحد فإياي فارهبون	wāḥidun fa iyyāya far-habụn
الدين واصبا	ad-dīnu wāṣibā
أفغير الله تتقون	a fa gairallāhi tattaqụn
فإليه تجأرون	fa ilaihi taj`arụn
إذا كشف الضر	iżā kasyafaḍ-ḍurr
فتمتعوا	fa tamatta’ụ
نصيبا مما رزقناهم	naṣībam mimmā razaqnāhum
تالله لتسألن	tallāhi latus`alunn
البنات سبحانه	al-banāti sub-ḥānah
أحدهم بالأنثى	aḥaduhum bil-unṡā
يتوارى من	yatawarā min
يدسه في التراب	yadussuhụ fit-turāb
بالآخرة مثل السوء	bil-ākhirati maṡalus-saụ`
المثل الأعلى	al-maṡalul-a’lā
ولو يؤاخذ	walau yu`ākhiż
يكرهون وتصف ألسنتهم	yakrahụna wa taṣifu alsinatuhum
وليهم اليوم ولهم	waliyyuhumul-yauma wa lahum
الذي اختلفوا فيه	allażikhtalafụ fīh
ماء فأحيا به الأرض	mā`an fa aḥyā bihil-arḍ
الأنعام لعبرة	al-an’āmi la’ibrah
سائغا للشاربين	sā`igal lisy-syāribīn
النخيل والأعناب	an-nakhīli wal-a’nāb
أن اتخذي من الجبال	anittakhiżī minal-jibāl
الثمرات فاسلكي	aṡ-ṡamarāti faslukī
شراب مختلف	syarābum mukhtalif
إلى أرذل العمر	ilā arżalil-‘umur
عليم قدير	‘alīmung qadīr
بعض في الرزق	ba’ḍin fir-rizq
فضلوا برادي رزقهم	fuḍḍilụ birāddī rizqihim
أفبنعمة الله يجحدون	a fa bini’matillāhi yaj-ḥadụn
بنين وحفدة ورزقكم	banīna wa ḥafadataw wa razaqakum
أفبالباطل يؤمنون	a fa bil-bāṭili yu`minụn
شيئا ولا يستطيعون	syai`aw wa lā yastaṭī’ụn
فلا تضربوا لله الأمثال	fa lā taḍribụ lillāhil-amṡāl
مثلا عبدا مملوكا	maṡalan ‘abdam mamlụkā
هل يستوون	hal yastawụn
مثلا رجلين أحدهما	maṡalar rajulaini aḥaduhumā
أينما يوجهه لا يأت	ainamā yuwajjihhu lā ya`t
كلمح البصر	kalam-ḥil-baṣar
والأبصار والأفئدة	wal-abṣāra wal-af`idah
إلى الطير مسخرات	ilaṭ-ṭairi musakhkharā
ما يمسكهن إلا الله	mā yumsikuhunna illallāh
وأوبارها وأشعارها أثاثا	wa aubārihā wa asy’ārihā aṡāṡā
وسرابيل تقيكم بأسكم	wa sarābīla taqīkum ba`sakum
يتم نعمته	yutimmu ni’matah
يعرفون نعمت	ya’rifụna ni’mat
أمة شهيدا ثم لا	ummatin syahīdan ṡumma lā
ظلموا العذاب	ẓalamul-‘ażāb
هؤلاء شركاؤنا	hā`ulā`i syurakā`unā
فألقوا إليهم القول	fa alqau ilaihimul-qaul
يومئذ السلم وضل	yauma`iżinis-salama wa ḍall
زدناهم عذابا فوق	zidnāhum ‘ażāban fauq
وجئنا بك شهيدا	wa ji`nā bika syahīdā
وإيتاء ذي القربى	wa ītā`i żil-qurbā
تنقضوا الأيمان	tangquḍul-aimān
قوة أنكاثا	quwwatin angkāṡā
هي أربى من أمة	hiya arbā min ummah
يبلوكم الله به	yablụkumullāhu bih
وليبينن لكم	wa layubayyinanna lakum
ولتسألن عما	wa latus`alunna ‘ammā
ثبوتها وتذوقوا السوء	ṡubụtihā wa tażụqus-sū`
تشتروا بعهد الله	tasytarụ bi’ahdillāh
ما عندكم ينفد	mā ‘indakum yanfad
صبروا أجرهم	ṣabarū ajrahum
فلنحيينه حياة طيبة	fa lanuḥyiyannahụ ḥayātan ṭayyibah
أجرهم بأحسن	ajrahum bi`aḥsan
قرأت القرآن فاستعذ	qara`tal-qur`āna fasta’iż
له سلطان على	lahụ sulṭānun ‘alā
الذين يتولونه	‘alallażīna yatawallaunah
أنت مفتر	anta muftar
بالحق ليثبت	bil-ḥaqqi liyuṡabbit
نعلم أنهم	na’lamu annahum
أعجمي وهذا لسان	a’jamiyyuw wa hāżā lisān
يفتري الكذب	yaftaril-każib
هم الكاذبون	humul-kāżibụn
شرح بالكفر صدرا	syaraḥa bil-kufri ṣadrā
بأنهم استحبوا الحياة	bi`annahumustaḥabbul-ḥayāh
وسمعهم وأبصارهم	wa sam’ihim wa abṣārihim
جرم أنهم	jarama annahum
ما فتنوا ثم جاهدوا	mā futinụ ṡumma jāhadụ
بعدها لغفور	ba’dihā lagafụr
تأتي كل نفس تجادل	ta`tī kullu nafsin tujādil
مطمئنة يأتيها	muṭma`innatay ya`tīhā
فكذبوه فأخذهم	fa każżabụhu fa akhażahum
طيبا واشكروا	ṭayyibaw wasykurụ
والدم ولحم الخنزير	wad-dama wa laḥmal-khinzīr
فمن اضطر غير باغ	fa maniḍṭurra gaira bāg
لما تصف ألسنتكم	limā taṣifu alsinatukum
متاع قليل ولهم	matā’ung qalīluw wa lahum
حرمنا ما قصصنا	ḥarramnā mā qaṣaṣnā
عملوا السوء بجهالة	‘amilus-sū`a bijahālah
أمة قانتا	ummatang qānitā
شاكرا لأنعمه اجتباه	syākiral li`an’umihijtabāh
لمن الصالحين	laminaṣ-ṣāliḥīn
أن اتبع ملة	anittabi’ millah
إنما جعل السبت	innamā ju’ilas-sabt
ليحكم بينهم	layaḥkumu bainahum
والموعظة الحسنة	wal-mau’iẓatil-ḥasanah
عاقبتم فعاقبوا	‘āqabtum fa ‘āqibụ
ولئن صبرتم	wa la`in ṣabartum
واصبر وما صبرك	waṣbir wa mā ṣabruk
هم محسنون	hum muḥsinụn
أسرى بعبده ليلا	asrā bi’abdihī lailā
وجعلناه هدى لبني	wa ja’alnāhu hudal libanī
حملنا مع نوح	ḥamalnā ma’a nụḥ
عبدا شكورا	‘abdan syakụrā
ولتعلن علوا كبيرا	wa lata’lunna ‘uluwwang kabīrā
فجاسوا خلال الديار	fa jāsụ khilālad-diyār
وعدا مفعولا	wa’dam maf’ụlā
وأمددناكم بأموال	wa amdadnākum bi`amwāl
أحسنتم لأنفسكم	aḥsantum li`anfusikum
وإن أسأتم فلها	wa in asa`tum fa lahā
علوا تتبيرا	‘alau tatbīrā
أن يرحمكم	ay yar-ḥamakum
عدتم عدنا	‘uttum ‘udnā
للكافرين حصيرا	lil-kāfirīna ḥaṣīrā
للتي هي أقوم	lillatī hiya aqwam
بالآخرة أعتدنا	bil-ākhirati a’tadnā
دعاءه بالخير	du’ā`ahụ bil-khaīr
الإنسان عجولا	al-insānu ‘ajụlā
آيتين فمحونا آية	āyataini fa maḥaunā āyah
فصلناه تفصيلا	faṣṣalnāhu tafṣīlā
إنسان ألزمناه طائره	insānin alzamnāhu ṭā`irah
كتابا يلقاه منشورا	kitābay yalqāhu mansyụrā
اقرأ كتابك	iqra` kitābak
عليك حسيبا	‘alaika ḥasībā
من اهتدى فإنما يهتدي	manihtadā fa innamā yahtadī
ضل فإنما يضل	ḍalla fa innamā yaḍill
تزر وازرة وزر	taziru wāziratuw wizr
معذبين حتى نبعث	mu’ażżibīna ḥattā nab’aṡ
فدمرناها تدميرا	fa dammarnāhā tadmīrā
بربك بذنوب عباده	birabbika biżunụbi ‘ibādih
يريد العاجلة عجلنا	yurīdul-‘ājilata ‘ajjalnā
يصلاها مذموما مدحورا	yaṣlāhā mażmụmam mad-ḥụrā
وسعى لها سعيها	wa sa’ā lahā sa’yahā
كلا نمد هؤلاء وهؤلاء	kullan numiddu hā`ulā`i wa hā`ulā`
عطاء ربك محظورا	‘aṭā`u rabbika maḥẓụrā
كيف فضلنا بعضهم	kaifa faḍḍalnā ba’ḍahum
درجات وأكبر تفضيلا	darajātiw wa akbaru tafḍīlā
فتقعد مذموما مخذولا	fa taq’uda mażmụmam makhżụlā
ألا تعبدوا إلا إياه	allā ta’budū illā iyyāh
إما يبلغن عندك	immā yabluganna ‘indak
ربياني صغيرا	rabbayānī ṣagīrā
في نفوسكم	fī nufụsikum
للأوابين غفورا	lil-awwābīna gafụrā
لا تبذر تبذيرا	lā tubażżir tabżīrā
المبذرين كانوا إخوان	al-mubażżirīna kānū ikhwān
قولا ميسورا	qaulam maisụrā
فتقعد ملوما محسورا	fa taq’uda malụmam maḥsụrā